ICY - Icy Bay
HGZ - Hogatza
BYW - Blakely Island
BDF - Bradford
BCS - Belle Chasse
BWL - Blackwell
DUF - Corolla
FOB - Fort Bragg
ALX - Alexander City
AFT - Bila
RNA - Arona
ATD - Atoifi
VEV - Barakoma
BPF - Batuna Mission Station
GEF - Liangia
AKS - Auki
BNY - Anua
BAS - Ballalae
FRE - Fera Island
HIR - Honiara
MBU - Mbambanakira
IRA - Kirakira
SCZ - Santa Cruz/Graciosa Bay/Luova
GZO - Gizo
MNY - Stirling Island
PRS - Parasi
RNL - Rennell Island
EGM - Sege
NNB - Santa Ana Island
RUS - Marau
VAO - Suavanao
XYA - Yandina
KGE - Kagau Island
KWS - Kwailabesi
GTA - Gatokae
RIN - Ringi Cove
RBV - Ramata
CEX - Chena Hot Springs
HED - Herendeen Bay
TWE - Taylor
CDL - Candle
BSZ - Egegik
BSW - Boswell Bay
INU - Yaren District
ATP - Aitape
AMU - Amanab
ADC - Andekombe
AIE - Aiome
AUJ - Ambunti
AWB - Awaba
AYU - Aiyura Valley
VMU - Baimuru
BUA - Buka Island
OPU - Balimo
BUL - Bulolo
CMU - Kundiawa
DER - Derim
DAU - Daru
XYR - Yellow River Mission
FNE - Fane Mission
FIN - Buki
FAQ - Frieda River
GKA - Goronka
GRL - Au
GAR - Garaina
GUR - Gurney
GAP - Gusap
PNP - Popondetta
GMI - Gasmata Island
GVI - Green River
HKN - Hoskins
KIE - Kieta
LSA - Losuia
KDR - Kandrian
UNG - Kiunga
KRI - Kikori
KMA - Kerema
KKD - Kokoda
KZF - Kaintiba
KUQ - Kuri
KVG - Kavieng
KWO - Kawito
LNV - Londolovit
LMY - Lake Murray
LMI - Lumi
MYX - Menyamya
MAG - Madang
HGU - Mount Hagen
MXK - Mindik
GUV - Mougulu
MXH - Moro
MIS - Misima Island
GBF - Negarbo
MFO - Manguna
UKU - Nuku
LAE - Nadzab
OSE - Omora
PDI - Pindiu
POM - Port Moresby
KMR - Karimui
NIS - Simberi Island
SIL - Sila Mission
SIM - Simbai
SKC - Suki
TIZ - Tari
TBG - Tabubil
TFM - Telefomin
TPI - Tapini
TAJ - Aitape
RAB - Tokua
TKW - Tekin
TFI - Tufi
WAO - Wabo
WWK - Wewak
WOA - Wonenara
WSU - Wasu
WTP - Fatima Mission
WUG - Wau
JEG - Aasiaat
UAK - Narsarsuaq
CNP - Neerlerit Inaat
GOH - Nuuk
JAV - Ilulissat
KUS - Kulusuk
JSU - Maniitsoq
JFR - Paamiut
NAQ - Qaanaaq
SFJ - Kangerlussuaq
JHS - Sisimiut
THU - Thule
JUV - Upernavik
JQA - Uummannaq
AEY - Akureyri
BIU - Bildudalur
BGJ - Borgarfjordur eystri
BJD - Bakkafjordur
BLO - Blonduos
BQD - Budardalur
BXV - Breiddalsvik
DJU - Djupivogur
EGS - Egilsstadir
FAS - Faskrudsfjordur
FAG - Fagurholsmyri
GUU - Grundarfjordur
GJR - Gjogur
GRY - Grimsey
HVK - Holmavik
HFN - Hornafjordur
FLI - Flateyri
HZK - Husavik
HVM - Hvammstangi
HLO - Onundarfjordur
IFJ - Isafjordur
KEF - Reykjavik
OPA - Kopasker
SAK - Saudarkrokur
NOR - Nordfjordur
OFJ - Olafsfjordur
PFJ - Patreksfjordur
RHA - Reykholar
OLI - Rif
RFN - Raufarhofn
RKV - Reykjavik
MVA - Myvatn
SIJ - Siglufjordur
SYK - Stykkisholmur
TEY - Tingeyri
THO - Thorshofn
VEY - Vestmannaeyjar
VPN - Vopnafjordur
PRN - Prishtina
YZZ - Trail
YAA - Anahim Lake
DGF - Douglas Lake
JHL - Albian Village
DUQ - Duncan
ZEL - Bella Bella
YWM - Williams Harbour
YFX - St. Lewis
YHA - Port Hope Simpson
YRG - Rigolet
DVK - Diavik
YCK - Colville Lake
YLE - Whati
NML - Fort McMurray
ZSP - St. Paul
DAS - Great Bear Lake
YFI - Suncor Energy Site
SUR - Summer Beaver
YAX - Angling Lake
WNN - Wunnumin Lake
YNO - North Spirit Lake
XBE - Bearskin Lake
KIF - Kingfisher Lake
YOG - Ogoki Post
YEB - Bar River
YHP - Poplar Hill
YNX - Snap Lake
YKU - Chisasibi
ZTB - Tete-a-la-Baleine
YAU - Kattiniq
ZLT - La Tabatiere
YAC - Cat Lake
YAR - La Grande-3
YAG - Fort Frances
YAH - La Grande-4
YAL - Alert Bay
YAM - Sault Ste Marie
XKS - Kasabonika
YKG - Kangirsuk
YAT - Attawapiskat
YAW - Halifax
YAY - St. Anthony
YAZ - Tofino
YBA - Banff
YBB - Kugaaruk
YBC - Baie-Comeau
QBC - Bella Coola
YBE - Uranium City
YBY - Bonnyville
YBG - Bagotville
YBK - Baker Lake
YBL - Campbell River
XTL - Tadoule Lake
YBR - Brandon
YBT - Brochet
YBV - Berens River
YBX - Lourdes-De-Blanc-Sablon
YRF - Cartwright
YCB - Cambridge Bay
YCC - Cornwall
YCD - Nanaimo
YCE - Centralia
YCG - Castlegar
YCH - Miramichi
XCM - Chatham-Kent
YCL - Charlo
YCN - Cochrane
YCO - Kugluktuk
YCQ - Chetwynd
YCR - Cross Lake
YCS - Chesterfield Inlet
YCT - Coronation
YCW - Chilliwack
YCY - Clyde River
YCZ - Fairmont Hot Springs
YDA - Dawson City
YDB - Burwash
YDF - Deer Lake
YDL - Dease Lake
YDM - Ross River
YDN - Dauphin
YDO - Dolbeau-St-Felicien
YDP - Nain
YDQ - Dawson Creek
YEG - Edmonton
YEK - Arviat
YEL - Elliot Lake
YEM - Manitowaning
YEN - Estevan
YER - Fort Severn
YET - Edson
YEU - Eureka
YEV - Inuvik
YEY - Amos
YFA - Fort Albany
YFB - Iqaluit
YFC - Fredericton
YFE - Forestville
YFH - Fort Hope
YTM - Riviere Rouge
YFO - Flin Flon
YFR - Fort Resolution
YFS - Fort Simpson
YMN - Makkovik
YGB - Texada
YGD - Goderich
YGH - Fort Good Hope
YGK - Kingston
YGL - La Grande Riviere
YGM - Gimli
YGO - Gods Lake Narrows
YGP - Gaspe
YGQ - Geraldton
YGR - Iles-de-la-Madeleine
YGT - Igloolik
YGV - Havre St-Pierre
YGW - Kuujjuarapik
YGX - Gillam
YGZ - Grise Fiord
YQC - Quaqtaq
YHB - Hudson Bay
YHD - Dryden
YHE - Hope
YHF - Hearst
YNS - Nemiscau
YHI - Ulukhaktok
YHK - Gjoa Haven
YHM - Hamilton
YHN - Hornepayne
YHO - Hopedale
YHR - Chevery
YHT - Haines Junction
YHU - Montreal
YHY - Hay River
YHZ - Halifax
YIB - Atikokan
YDG - Digby
YIF - St-Augustin
YIK - Ivujivik
YIO - Pond Inlet
YIV - Island Lake
YJA - Jasper
YJF - Fort Liard
YJN - St Jean
YJT - Stephenville
YKA - Kamloops
YKC - Collins Bay
LAK - Aklavik
YKF - Kitchener
YWB - Kangiqsujuaq
YKJ - Key Lake
YKL - Schefferville
AKV - Akulivik
YKQ - Waskaganish
YKX - Kirkland Lake
YKY - Kindersley
YKZ - Toronto
YPJ - Aupaluk
YLB - Lac La Biche
YLC - Kimmirut
YLD - Chapleau
YLH - Lansdowne House
YLJ - Meadow Lake
YSG - Lutselk'e
YLL - Lloydminster
YLQ - La Tuque
YLR - Leaf Rapids
YLK - Barrie-Orillia
YLT - Alert
XGR - Kangiqsualujjuaq
YLW - Kelowna
YMA - Mayo
YME - Matane
YMG - Manitouwadge
YMH - Mary's Harbour
YMJ - Moose Jaw
YML - Charlevoix
YMM - Fort McMurray
YMO - Moosonee
YMT - Chibougamau
YUD - Umiujaq
YMW - Maniwaki
YMX - Montreal
YNA - Natashquan
YNC - Wemindji
YND - Gatineau
YNE - Norway House
YNH - Hudson's Hope
YLY - Langley
YNL - Points North Landing
YNM - Matagami
YNN - Nejanilini Lake
HZP - Fort Mackay
YOA - Ekati
YOC - Old Crow
YOD - Cold Lake
YOH - Oxford House
YOJ - High Level
YOO - Oshawa
YOP - Rainbow Lake
YOS - Owen Sound
YOW - Ottawa
YPA - Prince Albert
YPC - Paulatuk
YPS - Port Hawkesbury
YPE - Peace River
YPG - Portage
YPH - Inukjuak
YPL - Pickle Lake
YPM - Pikangikum
YPN - Port-Menier
YPO - Peawanuck
YPQ - Peterborough
YPR - Prince Rupert
YPW - Powell River
YPX - Puvirnituq
YPY - Fort Chipewyan
YPZ - Burns Lake
YQA - Muskoka
YQB - Quebec
YQD - The Pas
YQF - Red Deer
YQG - Windsor
YQH - Watson Lake
YQI - Yarmouth
YQK - Kenora
YQL - Lethbridge
YQM - Moncton
YQN - Nakina
YQQ - Comox
YQR - Regina
YQS - St Thomas
YQT - Thunder Bay
YQU - Grande Prairie
YQV - Yorkton
YQW - North Battleford
YQX - Gander
YQY - Sydney
YQZ - Quesnel
YRA - Gameti
YRB - Resolute Bay
YRI - Riviere-du-Loup
YRJ - Roberval
YRL - Red Lake
YRM - Rocky Mountain House
YRO - Ottawa
YRP - Carp
YRQ - Trois-Rivieres
YRS - Red Sucker Lake
YRT - Rankin Inlet
YRV - Revelstoke
YSB - Sudbury
YSC - Sherbrooke
YSE - Squamish
YSF - Stony Rapids
YSH - Smiths Falls
YSJ - Saint John
YSK - Sanikiluaq
YSL - St Leonard
YSM - Fort Smith
YCM - St Catharines
YSP - Marathon
YST - St. Theresa Point
YSU - Summerside
YSY - Sachs Harbour
YTA - Pembroke
YTE - Cape Dorset
YTF - Alma
YTH - Thompson
YTL - Big Trout Lake
YTQ - Tasiujaq
YTR - Trenton
YTS - Timmins
YTZ - Toronto
YUB - Tuktoyaktuk
YUL - Montreal
YUT - Repulse Bay
YUX - Hall Beach
YUY - Rouyn-Noranda
YVB - Bonaventure
YVC - La Ronge
YVG - Vermilion
YVE - Vernon
YVM - Qikiqtarjuaq
YVO - Val-d'Or
YVP - Kuujjuaq
YVQ - Norman Wells
YVR - Vancouver
YVT - Buffalo Narrows
YVV - Wiarton
YVZ - Deer Lake
YWA - Petawawa
YFJ - Wekweeti
YWG - Winnipeg
YWJ - Deline
YWK - Wabush
YWL - Williams Lake
YWP - Webequie
YWY - Wrigley
YXC - Cranbrook
YXD - Edmonton
YXE - Saskatoon
YXH - Medicine Hat
YXJ - Fort St.John
YXK - Rimouski
YXL - Sioux Lookout
YXN - Whale Cove
YXP - Pangnirtung
YXQ - Beaver Creek
YXR - Earlton
YXS - Prince George
YXT - Terrace
YXU - London
YXX - Abbotsford
YXY - Whitehorse
YXZ - Wawa
YYB - North Bay
YYC - Calgary
YYD - Smithers
YYE - Fort Nelson
YYF - Penticton
YYG - Charlottetown
YYH - Taloyoak
YYJ - Victoria
YYL - Lynn Lake
YYM - Cowley
YYN - Swift Current
YYQ - Churchill
YYR - Goose Bay
YYT - St. John's
YYU - Kapuskasing
YYW - Armstrong
YYY - Mont-Joli
YYZ - Toronto
YZD - Toronto
YZE - Gore Bay
YZF - Yellowknife
YZG - Salluit
YZH - Slave Lake
YZP - Sandspit
YZR - Sarnia
YZS - Coral Harbour
YZT - Port Hardy
YZU - Whitecourt
YZV - Sept-Iles
YZW - Teslin
YZX - Greenwood
YZY - Mackenzie
ZAC - York Landing
YSN - Salmon Arm
YDT - Burlington
ZBD - Boundary Bay
ILF - Ilford
ZBF - Bathurst
ZBM - Bromont
ZEE - Kelsey
ZEM - Eastmain River
ZFA - Faro
ZFD - Fond-Du-Lac
ZFG - Pukatawagan
ZFM - Fort Mcpherson
ZFN - Tulita
ZGF - Grand Forks
ZGI - Gods River
ZGR - Little Grand Rapids
ZHP - High Prairie
ZJG - Jenpeg
ZJN - Swan River
ZKE - Kashechewan
YTD - Thicket Portage
MSA - Muskrat Dam
ZMH - 108 Mile
PIW - Pikwitonei
ZMT - Masset
ZNG - Poplar River
ZPB - Sachigo Lake
WPC - Pincher Creek
ZPO - Pinehouse Lake
ZRJ - Round Lake
ZSJ - Sandy Lake
ZSN - South Indian Lake
ZST - Stewart
YDV - Bloodvein River
ZTM - Shamattawa
ZUC - Ignace
ZUM - Churchill Falls
ZWH - Lac Brochet
ZWL - Wollaston Lake
BJA - Bejaia
ALG - Algiers
DJG - Djanet
VVZ - Illizi
QSF - Setif
TMR - Tamanrasset
GJL - Jijel
MZW - Mecheria
AAE - Annabah
CZL - Constantine
TEE - Tebessi
BLJ - Batna
TID - Tiaret
TIN - Tindouf
TLM - Tlemcen
ORN - Oran
CBH - Bechar
EBH - El Bayadh
INF - In Guezzam
BMW - Bordj Badji Mokhtar
BSK - Biskra
GHA - Ghardaia
HME - Hassi Messaoud
INZ - In Salah
TGR - Touggourt
LOO - Laghouat
ELU - Guemar
TMX - Timimoun
OGX - Ouargla
IAM - Amenas
COO - Cotonou
DJA - Djougou
KDC - Kandi
NAE - Natitingou
PKO - Parakou
SVF - Save
XKY - Kaya
OUG - Ouahigouya
XDJ - Djibo
XLU - Leo
PUP - Po
XBO - Boulsa
XBG - Bogande
DIP - Diapaga
DOR - Dori
FNG - Fada N'gourma
XGG - Gorom-Gorom
XKA - Kantchari
TMQ - Tambao
XPA - Pama
ARL - Arly
XSE - Sebba
TEG - Tenkodogo
XZA - Zabre
OUA - Ouagadougou
BNR - Banfora
DGU - Dedougou
XGA - Gaoua
XNU - Nouna
BOY - Bobo Dioulasso
TUQ - Tougan
XDE - Diebougou
XAR - Aribinda
ACC - Accra
TML - Tamale
KMS - Kumasi
NYI - Sunyani
TKD - Sekondi-Takoradi
ABJ - Abidjan
OGO - Abengourou
BXI - Boundiali
BQO - Bouna
BDK - Bondoukou
DIM - Dimbokro
FEK - Ferkessedougou
GGN - Gagnoa
GGO - Guiglo
BBV - Grand-Bereby
KEO - Odienne
OFI - Ouango Fitini
SEO - Seguela
ZSS - Sassandra
TXU - Tabou
ASK - Yamoussoukro
ABV - Abuja
AKR - Akure
ABB - Asaba
BNI - Benin
CBQ - Calabar
ENU - Enegu
GMO - Gombe
QUS - Gusau
IBA - Ibadan
ILR - Ilorin
QOW - Owerri
JOS - Jos
KAD - Kaduna
KAN - Kano
MIU - Maiduguri
MDI - Makurdi
LOS - Lagos
MXJ - Minna
PHC - Port Harcourt
SKO - Sokoto
NBE - Enfidha
YOL - Yola
ZAR - Zaria
MFQ - Maradi
NIM - Niamey
THZ - Tahoua
AJY - Agadez
RLT - Arlit
ZND - Zinder
TBJ - Tabarka
MIR - Monastir
TUN - Tunis
OIZ - Sidi Ahmed
GAF - Gafsa
GAE - Gabes
DJE - Djerba
EBM - El Borma
SFA - Sfax
TOE - Tozeur
LRL - Niamtougou
LFW - Lome
ANR - Antwerp
BRU - Brussels
CRL - Brussels
KJK - Wevelgem
LGG - Liege
QNM - Namur
OST - Ostend
QHA - Hasselt
OBL - Zoersel
AOC - Altenburg
HDF - Heringsdorf
ZHZ - Oppin
IES - Riesa
REB - Larz
BER - Berlin
CSO - Magdeburg
ZMG - Magdeburg
CBU - Cottbus
GTI - Rugen
KOQ - Kothen
PEF - Peenemunde
DRS - Dresden
ERF - Erfurt
FRA - Frankfurt-am-Main
FMO - Munster
HAM - Hamburg
THF - Berlin
CGN - Cologne
DUS - Dusseldorf
MUC - Munich
NUE - Nuremberg
LEJ - Leipzig
SCN - Saarbrucken
STR - Stuttgart
TXL - Berlin
HAJ - Hannover
BRE - Bremen
QEF - Egelsbach
HHN - Hahn
MHG - Mannheim
QMZ - Mainz
EIB - Eisenach
XFW - Hamburg
KEL - Kiel
LBC - Lubeck
EUM - Neumunster
FMM - Memmingen
AAH - Aachen
BNJ - Bonn
BFE - Bielefeld
ZOJ - Marl
MGL - Monchengladbach
PAD - Paderborn
NRN - Weeze
DTM - Dortmund
AGB - Augsburg
RBM - Straubing
FDH - Friedrichshafen
FRF - Oschersleben
BYU - Bayreuth
URD - Ebermannstadt
QOB - Ansbach
HOQ - Hof
BBJ - Bitburg
ZQW - Zweibrucken
FKB - Baden-Baden
ZQL - Donaueschingen
KSF - Kassel
BRV - Bremerhaven
XLW - Lemwerder
EME - Emden
AGE - Wangerooge
WVN - Wilhelmshaven
JUI - Juist
LGO - Langeoog
ZOW - Klausheide
BMK - Borkum
NOD - Norddeich
VAC - Cloppenburg
NRD - Norderney
BMR - Baltrum
HEI - Busum
FLF - Flensburg
HGL - Helgoland
QHU - Husum
PSH - Sankt Peter-Ording
GWT - Westerland
OHR - Wyk auf Fohr
KDL - Kardla
URE - Kuressaare
EPU - Parnu
TLL - Tallinn
TAY - Tartu
ENF - Enontekio
QVE - Forssa
KEV - Halli / Kuorevesi
HEM - Helsinki
HEL - Helsinki
IVL - Ivalo
JOE - Joensuu / Liperi
JYV - Jyvaskylan Maalaiskunta
KAU - Kauhava
KEM - Kemi / Tornio
KAJ - Kajaani
KOK - Kokkola / Kruunupyy
KAO - Kuusamo
KTT - Kittila
KUO - Kuopio / Siilinjarvi
LPP - Lappeenranta
MIK - Mikkeli
OUL - Oulu / Oulunsalo
POR - Pori
RVN - Rovaniemi
SVL - Savonlinna
SJY - Seinajoki / Ilmajoki
SOT - Sodankyla
TMP - Tampere / Pirkkala
TKU - Turku
UTI - Utti / Valkeala
VAA - Vaasa
VRK - Varkaus / Joroinen
LHB - Bruntingthorpe
BFS - Belfast
ENK - Enniskillen
BHD - Belfast
LDY - Derry
BHX - Birmingham
CVT - Coventry
GLO - Staverton
ORM - Northampton
NQT - Nottingham
GBA - Kemble
MAN - Manchester
DSA - Doncaster
UPV - Upavon
LYE - Lyneham
DGX - St. Athan
YEO - Yeovil
CAL - Campbeltown
EOI - Eday
FIE - Fair Isle
WHS - Whalsay
COL - Coll Island
NRL - North Ronaldsay
OBN - North Connel
PPW - Papa Westray
SOY - Stronsay
NDY - Sanday
LWK - Lerwick
WRY - Westray
CSA - Colonsay
HAW - Haverfordwest
CWL - Cardiff
SWS - Swansea
BRS - Bristol
LPL - Liverpool
LTN - London
LEQ - Land's End
PLH - Plymouth
ISC - St. Mary's
BOH - Bournemouth
SOU - Southampton
BBP - Bembridge
QLA - Lasham
NQY - Newquay
QUG - Chichester
ACI - Saint Anne
GCI - Saint Peter Port
JER - Saint Helier
ESH - Brighton
BQH - London
LGW - London
KRH - Redhill
LCY - London
FAB - Farnborough
BBS - Yateley
LHR - London
SEN - Southend
LYX - Lydd
MSE - Manston
CAX - Carlisle
BLK - Blackpool
HUY - Grimsby
BWF - Barrow-in-Furness
LBA - Leeds
WRT - Warton
CEG - Hawarden
IOM - Castletown
NCL - Newcastle
MME - Durham
EMA - Nottingham
HLY - Angelsey
KOI - Orkney Islands
LSI - Lerwick
WIC - Wick
ABZ - Aberdeen
INV - Inverness
GLA - Glasgow
EDI - Edinburgh
ILY - Port Ellen
PIK - Glasgow
BEB - Balivanich
SCS - Shetland Islands
DND - Dundee
SYY - Stornoway
BRR - Eoligarry
PSL - Perth
TRE - Balemartine
UNT - Shetland Islands
BOL - Ballykelly
FSS - Kinloss
ADX - St. Andrews
LMO - Lossiemouth
CBG - Cambridge
NWI - Norwich
STN - London
QFO - Duxford
HYC - High Wycombe
EXT - Exeter
FZO - Bristol
OXF - Kidlington
RCS - Rochester
BEX - Benson
LKZ - Lakenheath
MHZ - Mildenhall
QUY - St. Ives
FFD - Fairford
BZZ - Brize Norton
ODH - Odiham
WXF - Wethersfield
NHT - London
QCY - Coningsby
BEQ - Thetford
OKH - Cottesmore
SQZ - Scampton
HRT - Linton-On-Ouse
WTN - Waddington
MRH - Marham
MPN - Mount Pleasant
AMS - Amsterdam
MST - Maastricht
QAR - Arnhem
EIN - Eindhoven
GRQ - Groningen
GLZ - Breda
DHR - Den Helder
LEY - Lelystad
LWR - Leeuwarden
RTM - Rotterdam
ENS - Enschede
UDE - Uden
WOE - Bergen Op Zoom
BYT - Bantry
BLY - Belmullet
NNR - Inverin
CLB - Castlebar
WEX - Wexford
ORK - Cork
GWY - Galway
CFN - Donegal
DUB - Dublin
IOR - Inis Mor
INQ - Inis Oirr
KKY - Kilkenny
NOC - Charleston
KIR - Killarney
LTR - Letterkenny
IIA - Inis Meain
SNN - Shannon
SXL - Sligo
WAT - Waterford
AAR - Aarhus
BLL - Billund
CPH - Copenhagen
EBJ - Esbjerg
KRP - Karup
BYR - Laeso
MRW - Lolland Falster / Maribo
ODE - Odense
RKE - Copenhagen
RNN - Ronne
SGD - Sonderborg
CNL - Sindal
SKS - Vojens
SQW - Skive
TED - Thisted
FAE - Vagar
STA - Skjern / Ringkobing
AAL - Aalborg
LUX - Luxembourg
AES - Alesund
ANX - Andenes
ALF - Alta
FDE - Forde
BNN - Bronnoy
BOO - Bodo
BGO - Bergen
BJF - Batsfjord
BVG - Berlevag
KRS - Kjevik
DLD - Dagali
BDU - Malselv
EVE - Evenes
FRO - Floro
OSL - Oslo
HMR - Hamar
HAU - Karmoy
HFT - Hammerfest
HAA - Hasvik
HVG - Honningsvag
KSU - Kvernberget
GLL - Klanten
KKN - Kirkenes
FAN - Farsund
LKN - Leknes
MEH - Mehamn
MOL - Aro
LKL - Lakselv
NVK - Narvik
OSY - Namsos
OLA - Orland
HOV - Orsta
MQN - Mo i Rana
RVK - Rorvik
RRS - Roros
RYG - Rygge
SRP - Svea
LYR - Longyearbyen
SDN - Sandane
SOG - Sogndal
SVJ - Svolvaer
SKN - Hadsel
SKE - Geiteryggen
SRP - Leirvik
SOJ - Sorkjosen
VAW - Vardo
SSJ - Alstahaug
TOS - Tromso
TRF - Torp
TRD - Trondheim
VDS - Vadso
SVG - Stavanger
QYY - Bialystok
BXP - Biala Podlaska
BZG - Bydgoszcz
CZW - Czestochowa
GDN - Gdansk
KRK - Krakow
KTW - Katowice
QEO - Czechowice-Dziedzice
LUZ - Lublin
LCJ - Lodz
WMI - Warsaw
QWS - Nowy Targ
QYD - Gdynia
QPM - Opole
POZ - Poznan
RDO - Radom
CZW - Czestochowa
RZE - Rzeszow
SZZ - Goleniow
ZWK - Suwalki
SZY - Szymany
WAW - Warsaw
WRO - Wroclaw
IEG - Babimost
XWP - Hassleholm
GOT - Gothenburg
JKG - Jonkoping
LDK - Lidkoping
GSE - Gothenburg
KVB - Skovde
THN - Trollhattan
NYO - Stockholm / Nykoping
KID - Kristianstad
MMX - Malmo
HAD - Halmstad
VXO - Vaxjo
GEV - Gallivare
KRF - Kramfors / Solleftea
SDL - Sundsvall/ Harnosand
OER - Ornskoldsvik
SFT - Skelleftea
UME - Umea
AJR - Arvidsjaur
SOO - Soderhamn
OSD - Ostersund
ORB - Orebro
KSD - Karlstad
VST - Stockholm / Vasteras
LLA - Lulea
ARN - Stockholm Arlanda
BMA - Stockholm
GVX - Gavle / Sandviken
LPI - Linkoping
NRK - Norrkoping
EKT - Eskilstuna
VBY - Visby
VVK - Vastervik
AGH - Angelholm
IDB - Idre
SPM - Trier
RMS - Ramstein
ZCD - Bamberg
FRZ - Fritzlar
RLG - Rostock
WIE - Wiesbaden
FEL - Furstenfeldbruck
IGS - Manching
GUT - Gutersloh
DGP - Daugavpils
LPX - Liepaja
RIX - Riga
VNT - Ventspils
KUN - Kaunas
KLJ - Klaipeda
PLQ - Palanga
PNV - Panevezys
SQQ - Siauliai
HLJ - Barysiai
VNO - Vilnius
ALJ - Alexander Bay
AGZ - Aggeneys
ADY - Alldays
BIY - Bisho
BFN - Bloemfontain
UTE - Bultfontein
CDO - Cradock
CPT - Cape Town
DUK - Mubatuba
PZL - Phinda
ELS - East London
EMG - Empangeni
ELL - Ellisras
FCB - Ficksburg
GCJ - Midrand
GRJ - George
GIY - Giyani
QRA - Johannesburg
HLW - Hluhluwe
HRS - Harrismith
HDS - Hoedspruit
KXE - Klerksdorp
KIM - Kimberley
MQP - Mpumalanga
KOF - Komatipoort
KMH - Kuruman
KLZ - Kleinsee
HLA - Johannesburg
LMR - Lime Acres
LDZ - Londolozi
DUR - Durban
LUJ - Lusikisiki
LCD - Louis Trichardt
SDB - Langebaanweg
LAY - Ladysmith
AAM - Malamala
MGH - Margate
MEZ - Musina
MBD - Mafeking
LLE - Malelane
MZY - Mossel Bay
MEZ - Silveroaks
MZQ - Mkuze
NCS - Newcastle
NGL - Ngala
NLP - Nelspruit
OVG - Overberg
OUH - Oudtshoorn
JNB - Johannesburg
AFD - Port Alfred
PLZ - Port Elizabeth
PBZ - Plettenberg Bay
PHW - Phalaborwa
JOH - Port St Johns
PRK - Prieska
PZB - Pietermaritzburg
NTY - Pilanesberg
PTG - Potgietersrus
PCF - Potchefstroom
UTW - Queenstown
RCB - Richards Bay
RVO - Reivilo
ROD - Robertson
SBU - Springbok
ZEC - Secunda
GSS - Belfast
SIS - Sishen
SZK - Skukuza
TDT - Welverdiend
THY - Thohoyandou
TCU - Homeward
LTA - Tzaneen
ULD - Ulundi
UTN - Upington
ULX - Ulusaba
UTT - Mthatha
VRU - Vyrburg
VIR - Durban
VRE - Vredendal
VYD - Vryheid
PRY - Pretoria
WKF - Pretoria
WEL - Welkom
FRW - Francistown
GNZ - Ghanzi
BBK - Kasane
KHW - Khwai River Lodge
MUB - Maun
QPH - Palapye
GBE - Gaborone
SVT - Savuti
SWX - Shakawe
TLD - Tuli Lodge
TBY - Tshabong
BZV - Brazzaville
DJM - Djambala
KNJ - Kindamba
LCO - Lague
MUY - Mouyondzi
SIB - Sibiti
NKY - Nkayi
ANJ - Zanaga
MSX - Mossendjo
BOE - Boundji
EWO - Ewo
GMM - Gamboma
ION - Impfondo
KEE - Kelle
MKJ - Makoua
FTX - Owando
SOE - Souanke
BTB - Betou
KMK - Makabana
DIS - Dolisie
PNR - Pointe Noire
MTS - Manzini
CRF - Carnot
BGF - Bangui
BGU - Bangassou
IRO - Birao
BEM - Bossembele
BBY - Bambari
NDL - N'Dele
BOP - Bouar
BIV - Bria
BSN - Bossangoa
BBT - Berberati
ODA - Ouadda
AIG - Yalinga
IMO - Zemio
MKI - Mboki
BTG - Batangafo
GDI - Melle
BMF - Bakouma
ODJ - Ouanda Djalle
RFA - Rafai
BCF - Bouca
BOZ - Bozoum
SSG - Malabo
ASI - Ascension Island
MRU - Port Louis
RRG - Port Mathurin
NKW - Diego Garcia
NKS - Nkongsamba
KBI - Kribi
TKC - Tiko
DLA - Douala
MMF - Mamfe
BLC - Bali
KLE - Kaele
OUR - Batouri
GXX - Yagoua
MVR - Maroua
FOM - Foumban
NGE - N'Gaoundere
BTA - Bertoua
GOU - Garoua
DSC - Dschang
BFX - Bafoussam
BPC - Bamenda
EBW - Ebolowa
YAO - Yaounde
NSI - Yaounde
MMQ - Mbala
CIP - Chipata
JEK - Lower Zambezi National Park
ZKP - Kasompe
LUN - Lusaka
KLB - Kalabo
KMZ - Kaoma
KAA - Kasama
ZKB - Kasaba Bay
LVI - Livingstone
LXU - Lukulu
LUN - Lusaka
MNS - Mansa
MFU - Mfuwe
MNR - Mongu
ZGM - Ngoma
NLA - Ndola
SXG - Senanga
KIW - Kitwe
SJQ - Sesheke
SLI - Solwesi
BBZ - Zambezi
HAH - Moroni
YVA - Moroni
AJN - Ouani
DZA - Dzaoudzi
RUN - St Denis
ZSE - St Pierre
OHB - Moramanga
WML - Malaimbandy
ATJ - Antsirabe
WAQ - Antsalova
VVB - Mahanoro
TNR - Antananarivo
JVA - Ankavandra
BMD - Belo sur Tsiribihina
MXT - Maintirano
ILK - Ilaka
TVA - Morafenobe
WTA - Tambohorano
WTS - Tsiroanomandidy
VAT - Vatomandry
WAM - Ambatondrazaka
WMR - Mananara Nord
WBD - Befandriana
WPB - Port Berge
IVA - Ambanja
NOS - Nosy Be
DWB - Soalala
WMP - Mampikony
TTS - Tsaratanana
WAI - Antsohihy
WMA - Mandritsara
WBO - Beroroha
WMD - Mandabe
FTU - Tolanaro
IHO - Ihosy
MJA - Manja
OVA - Bekily
TDV - Tanandava
VND - Vangaindrano
BKU - Betioky
AMP - Ampanihy
WAK - Ankazoabo
AZZ - Ambriz
SSY - Mbanza Congo
BUG - Benguela
CAB - Cabinda
CFF - Cafunfo
PGI - Chitato
CBT - Catumbela
CTI - Cuito Cuanavale
CXM - Camaxilo
CAV - Cazombo
DUE - Chitato
VPE - Ngiva
NOV - Huambo
SVP - Kuito
LLT - Lobito
LBZ - Lucapa
LAD - Luanda
LZM - Luzamba
MEG - Malanje
SPP - Menongue
MSZ - Namibe
GXG - Negage
PBN - Port Amboim
VHC - Saurimo
SZA - Soyo
NDD - Sumbe
UAL - Luau
SDD - Lubango
LUO - Luena
UGO - Uige
CEO - Waco Kungo
XGN - Xangongo
ARZ - N'zeto
NZA - Nzagi
BGB - Booue
KDN - Ndende
FOU - Fougamou
MBC - M'Bigou
MGX - Moabi
KDJ - N'Djole
KOU - Koulamoutou
MJL - Mouila
OYE - Oyem
OKN - Okondja
LBQ - Lambarene
MVX - Minvoul
BMM - Bitam
MFF - Moanda
MKB - Mekambo
POG - Port Gentil
OMB - Omboue
MKU - Makokou
LBV - Libreville
MZC - Mitzic
MVB - Franceville
LTL - Lastourville
ZKM - Sette Cama
TCH - Tchibanga
MYB - Mayumba
TMS - Sao Tome
ANO - Angoche
BEW - Beira
FXO - Cuamba
VPY - Chimoio
IHC - Inhaca
INH - Inhambabe
VXC - Lichinga
LFB - Lumbo
MPM - Maputo
MUD - Mueda
MZB - Mocimboa da Praia
MNC - Nacala
APL - Nampula
POL - Pemba / Porto Amelia
PDD - Ponta do Ouro
UEL - Quelimane
TET - Tete
VNX - Vilanculo
VJB - Xai-Xai
DES - Desroches Island
SEZ - Mahe Island
PRI - Praslin Island
BDI - Bird Island
DEI - Denis Island
FRK - Fregate Island
SRH - Sarh
OGR - Bongor
LTC - Lai
ATV - Ati
NDJ - N'Djamena
BKR - Bokoro
OTC - Bol
MVO - Mongo
AMC - Am Timan
PLF - Pala
OUT - Bousso
AMO - Mao
BUQ - Bulawayo
CHJ - Chipinge
BFO - Chiredzi
VFA - Victoria Falls
HRE - Harare
KAB - Kariba
MVZ - Masvingo
GWE - Gweru
HWN - Hwange
WKI - Hwange
BLZ - Blantyre
CMK - Club Makokola
DWA - Dwangwa
KGJ - Karonga
KBQ - Kasungu
LLW - Lilongwe
LIX - Likoma Island
MAI - Mangochi
MYZ - Monkey Bay
LMB - Salima
ZZU - Mzuzu
LEF - Lebakeng
LRB - Leribe
LES - Lesobeng
MSG - Matsaile
MFC - Mafeteng
MKH - Mokhotlong
MSU - Maseru
NKU - Nkaus
PEL - Pelaneng
UTG - Quthing
UNE - Qacha's Nek
SHK - Sehonghong
SKQ - Sekakes
SOK - Semonkong
SHZ - Seshutes
THB - Thaba-Tseka
TKO - Tlokoeng
ADI - Arandis
GOG - Gobabis
GFY - Grootfontein
MPA - Mpacha
KMP - Keetmanshoop
LHU - Muneambuanas
LUD - Luderitz
OKU - Mokuti Lodge
NNI - Namutoni
OND - Ondangwa
OMG - Omega
OMD - Oranjemund
OKF - Okaukuejo
OTJ - Otjiwarongo
NDU - Rundu
RHN - Rosh Pinah
SWP - Swakopmund
TSB - Tsumeb
WVB - Walvis Bay
ERS - Windhoek
WDH - Windhoek
FIH - Kinshasa
BOA - Boma
LZI - Luozi
MAT - Matadi
NKL - Nkolo Fuma
INO - Inongo
NIO - Nioki
KRZ - Kiri
IDF - Idiofa
LUS - Lusanga
MSM - Masi Manimba
MDK - Mbandaka
BSU - Basankusu
LIE - Libenge
GMA - Gemena
BMB - Bumbar
BNB - Boende
IKL - Ikela
FKI - Kisangani
YAN - Yangambi
RUE - Butembo
GOM - Goma
BNC - Beni
KND - Kindu
KLY - Kalima
KGN - Kasongo
PUN - Punia
FBM - Lubumbashi
PWO - Pweto
KEC - Kasenga
MNO - Manono
BDV - Moba
KBO - Kabalo
KOO - Kongolo
KMN - Kamina
KAP - Kapanga
KNM - Kaniama
KGA - Kananga
LZA - Luiza
TSH - Tshikapa
LJA - Lodja
LBO - Lusambo
MEW - Mweka
BAN - Basongo
PFR - Ilebo
MJM - Mbuji Mayi
GDJ - Gandajika
KBN - Kabinda
BKO - Senou
GUD - Goundam
KNZ - Kenieba
KTX - Koutiala
NRM - Nara
NIX - Nioro du Sahel
KSS - Sikasso
TOM - Timbuktu
EYL - Yelimane
BJL - Banjul
FUE - Fuerteventura Island
GMZ - Alajero
VDE - El Hierro Island
SPC - Sta Cruz de la Palma
LPA - Gran Canaria Island
ACE - Lanzarote Island
TFS - Tenerife Island
TFN - Tenerife Island
MLN - Melilla Island
BTE - Bonthe
KBS - Bo
GBK - Gbangbatok
HGS - Freetown
KBA - Kabala
KEN - Kenema
FNA - Freetown
WYE - Yengema
BQE - Bubaque
OXB - Bissau
UCN - Buchanan
CPA - Harper
SNI - Greenville
MLW - Monrovia
NIA - Nimba
ROB - Monrovia
SAZ - Sasstown
THC - Tchien
VOI - Voinjama
AGA - Agadir
TTA - Tan Tan
OZG - Zagora
UAR - Bouarfa
FEZ - Fes
ERH - Errachidia
MEK - Meknes
OUD - Oujda
SMW - Smara
GMD - Ben Slimane
CAS - Casablanca
RBA - Rabat
SII - Sidi Ifni
VIL - Dakhla
ESU - Essaouira
EUN - El Aaiun
CMN - Casablanca
SFI - Safi
NDR - Nador
RAK - Marrakech
OZZ - Ouarzazate
AHU - Al Hoceima
TNG - Tangier
DSS - Diass
KDA - Kolda
ZIG - Ziguinchor
CSK - Cap Skirring
KLC - Kaolack
DKR - Dakar
MAX - Matam
POD - Podor
RDT - Richard Toll
XLS - Saint Louis
BXE - Bakel
KGG - Kedougou
SMY - Simenti
TUD - Tambacounda
AEO - Aioun El Atrouss
OTL - Boutilimit
THI - Tichitt
TIY - Tidjikja
BGH - Boghe
KFA - Kiffa
TMD - Timbedra
EMN - Nema
AJJ - Akjoujt
KED - Kaedi
MOM - Moudjeria
NKC - Nouakchott
SEY - Selibaby
THT - Tamchakett
ATR - Atar
FGD - Fderik
NDB - Nouadhibou
OUZ - Zouerate
CKY - Conakry
KSI - Kissidougou
MCA - Macenta
NZE - Nzerekore
BKJ - Boke
SBI - Koundara
GII - Siguiri
KNN - Kankan
SID - Espargos
NTO - Ponta do Sol
BVC - Rabil
BVR - Brava Island
MMO - Vila do Maio
MTI - Vila do Mosteiros
RAI - Praia
SFL - Sao Filipe
SNE - Preguica
VXE - Sao Pedro
ADD - Addis Ababa
BCO - Baco
BJR - Bahir Dar
BEI - Beica
DSE - Dessie
DEM - Dembidollo
DBM - Debra Marcos
DIR - Dire Dawa
DBT - Debre Tabor
FNH - Fincha
GOB - Goba
GNN - Ghinnir
GMB - Gambela
GDQ - Gondar
GDE - Gode
GOR - Gore
QHR - Debre Zeyit
HUE - Humera
JIJ - Jijiga
JIM - Jimma
ABK - Kabri Dehar
LFO - Kelafo
AWA - Awassa
LLI - Lalibela
TUJ - Maji
MZX - Masslo
ETE - Metema
NDM - Mendi
MTF - Mizan Teferi
NEJ - Nejjo
NEK - Nekemte
SHC - Shire
SXU - Soddu
SZE - Semera
ASO - Asosa
TIE - Tippi
WAC - Waca
BJM - Bujumbura
GID - Gitega
KRE - Kirundo
ALU - Alula
BIB - Baidoa
CXN - Candala
HCM - Eil
BSA - Bosaso
GSR - Gardo
HGA - Hargeisa
BBO - Berbera
MGQ - Mogadishu
CMO - Obbia
GLK - Galcaio
CMS - Scusciuban
ERA - Erigavo
BUO - Burao
JIB - Djibouti City
AII - Ali-Sabieh
MHI - Moucha Island
OBC - Obock
TDJ - Tadjoura
SEW - Siwa
DBB - El Alamein
AAC - El Arish
ATZ - Assiut
ALY - Alexandria
HBE - Alexandria
ABS - Abu Simbel
CAI - Cairo
CWE - El Cairo
HRG - Hurghada
LXR - Luxor
RMF - Marsa Alam
HMB - Sohag
MUH - Mersa Matruh
PSD - Port Said
SSH - Sharm el-Sheikh
ASW - Aswan
SPX - Giza
TCP - Taba
ASM - Asmara
MSW - Massawa
ASA - Asab
TES - Tessenei
ASV - Amboseli National Park
EDL - Eldoret
EYS - Eliye Springs
KLK - Kalokol
GAS - Garissa
HOA - Hola
NBO - Nairobi
KEU - Keekorok
GGM - Kakamega
KIS - Kisumu
ILU - Kilaguni
KEY - Kericho
KTL - Kitale
LKG - Lokichoggio
LOK - Lodwar
LAU - Lamu
LOY - Loyengalani
NDE - Mandera
RBT - Marsabit
JJM - Meru-Kinna
MYD - Malindi
MBA - Mombasa
MRE - Masai Mara
OYL - Moyale (Lower)
NYE - Nyeri
NUU - Nakuru
WIL - Nairobi
NYK - Nanyuki
UAS - Samburu South
UKA - Ukunda
WJR - Wajir
SRX - Sirt
TOB - Tobruk
GHT - Ghat
AKF - Kufra
BEN - Benghazi
MJI - Tripoli
LAQ - Al Bayda'
SEB - Sabha
TIP - Tripoli
NFR - Nafurah 1
LTD - Ghadames
WAX - Zuwara
GYI - Gisenyi
BTQ - Butare
KGL - Kigali
RHG - Ruhengeri
KME - Kamembe
ATB - Atbara
EDB - El Debba
DOG - Dongola
RSS - Ad Damazin
ELF - El Fasher
GSU - Gedaref
DNX - Dinder
EGN - Geneina
HEG - Heglig Oilfield
KSL - Kassala
GBU - Khashm El Girba
KST - Kosti
KDX - Kadugli
RBX - Rumbek
MWE - Merowe
NUD - En Nahud
UYL - Nyala
NHF - New Halfa
EBD - Al-Ubayyid
PZU - Port Sudan
JUB - Juba
MAK - Malakal
KRT - Khartoum
WHF - Wadi Halfa
WUU - Wau
ZLX - Zalingei
ARK - Arusha
BKZ - Bukoba
DAR - Dar es Salaam
DOD - Dodoma
IRI - Nduli
TKQ - Kigoma
KIY - Kilwa Masoko
JRO - Arusha
LDI - Lindi
LKY - Lake Manyara National Park
MFA - Mafia Island
MBI - Mbeya
MWN - Mwadui
XMI - Masasi
QSI - Moshi
MYW - Mtwara
MUZ - Musoma
MWZ - Mwanza
NCH - Nachingwea
JOM - Njombe
PMA - Chake
SEU - Seronera
SGX - Songea
SUT - Sumbawanga
SHY - Shinyanga
TBO - Tabora
TGT - Tanga
ZNZ - Kiembi Samaki
RUA - Arua
EBB - Kampala
ULU - Gulu
JIN - Jinja
KBG - Kabalega Falls
KSE - Kasese
MBQ - Mbarara
KCU - Masindi
SRT - Soroti
TRY - Tororo
AMK - Durango
BDX - Broadus
FID - Fishers Island
GCW - Peach Springs
RKC - Montague
GNF - Quincy
GTP - Grants Pass
GCD - Electric City
FPY - Perry
FMU - Florence
ATE - Antlers
AAF - Apalachicola
ABE - Allentown
ABI - Abilene
ABQ - Albuquerque
ABR - Aberdeen
ABY - Albany
ACB - Bellaire
ACK - Nantucket
ACT - Waco
ACV - Arcata/Eureka
ACY - Atlantic City
ADG - Adrian
ADT - Ada
ADM - Ardmore
ADS - Dallas
ADW - Camp Springs
AEL - Albert Lea
AEX - Alexandria
AFF - Colorado Springs
WSG - Washington
AFN - Jaffrey
AFO - Afton
AFW - Fort Worth
AGC - Pittsburgh
AGO - Magnolia
AGS - Augusta
AHC - Herlong
AHH - Amery
AHN - Athens
AIA - Alliance
AID - Anderson
AIK - Aiken
AIO - Atlantic
AIV - Aliceville
AIZ - Kaiser Lake Ozark
AKO - Akron
AKC - Akron
ALB - Albany
ALI - Alice
ALM - Alamogordo
ALN - Alton/St Louis
ALO - Waterloo
ALS - Alamosa
ALW - Walla Walla
AMA - Amarillo
AMN - Alma
AMW - Ames
ANB - Anniston
AND - Anderson
SLT - Salida
ANP - Annapolis
ANQ - Angola
ANW - Ainsworth
ANY - Anthony
AOH - Lima
AOO - Altoona
APA - Denver
APC - Napa
APF - Naples
APG - Aberdeen Proving Grounds(Aberdeen)
APH - Fort A. P. Hill
APN - Alpena
APT - Jasper
APV - Apple Valley
ARA - New Iberia
ARB - Ann Arbor
ARG - Walnut Ridge
WHT - Wharton
AUZ - Chicago/Aurora
ART - Watertown
ARV - Minocqua-Woodruff
BFT - Beaufort
ASE - Aspen
SPZ - Springdale
ASH - Nashua
ASL - Marshall
ASN - Talladega
AST - Astoria
ASX - Ashland
ASY - Ashley
ATL - Atlanta
ATS - Artesia
ATW - Appleton
ATY - Watertown
AUG - Augusta
AUM - Austin
AUN - Auburn
AUO - Auburn
AUS - Austin
AUW - Wausau
AVL - Asheville
AVO - Avon Park
AVP - Wilkes-Barre/Scranton
AVW - Tucson
AVX - Avalon
AWM - West Memphis
AXG - Algona
AXN - Alexandria
AXS - Altus
AXV - Wapakoneta
AXX - Angel Fire
AYS - Waycross
AZO - Kalamazoo
BAB - Marysville
BAD - Bossier City
BAF - Westfield/Springfield
CLU - Columbus
BAM - Battle Mountain
BBB - Benson
BBD - Brady
BKG - Branson
BTN - Bennettsville
BBW - Broken Bow
BCB - Blacksburg
BCE - Bryce Canyon
BCT - Boca Raton
BDE - Baudette
BDG - Blanding
ILL - Willmar
BDL - Hartford
BDR - Bridgeport
WBU - Boulder
BEC - Wichita
BED - Bedford
BEH - Benton Harbor
BFD - Bradford
BFF - Scottsbluff
BFI - Seattle
BFL - Bakersfield
BFM - Mobile
BFR - Bedford
BGD - Borger
BGE - Bainbridge
BGM - Binghamton
BGR - Bangor
BHB - Bar Harbor
BHM - Birmingham
BID - Block Island
BIE - Beatrice
BIF - Fort Bliss/El Paso
BIH - Bishop
BIL - Billings
BIS - Bismarck
BIX - Biloxi
BJC - Denver
BJI - Bemidji
BJJ - Wooster
BKD - Breckenridge
BKE - Baker City
BFK - Aurora
BKL - Cleveland
BWL - Blackwell
BKT - Blackstone
BKW - Beckley
BKX - Brookings
BLF - Bluefield
BLH - Blythe
BLI - Bellingham
BLM - Belmar/Farmingdale
BLU - Emigrant Gap
BLV - Belleville
BMC - Brigham City
BMG - Bloomington
BMI - Bloomington-Normal
BML - Berlin
BMT - Beaumont
BNA - Nashville
BNG - Banning
BNL - Barnwell
BNO - Burns
BNW - Boone
BOI - Boise
BOS - Boston
BOW - Bartow
BGS - Big Spring
BPI - Big Piney
WMH - Mountain Home
BWM - Bowman
BPT - Beaumont/Port Arthur
BQK - Brunswick
BRD - Brainerd
BRL - Burlington
BRO - Brownsville
BRY - Bardstown
BTF - Bountiful
BTL - Battle Creek
BTM - Butte
TTO - Britton
BTP - Butler
BTR - Baton Rouge
BTV - Burlington
BTY - Beatty
BUB - Burwell
BUF - Buffalo
BUM - Butler
BUR - Burbank
BFP - Beaver Falls
BVO - Bartlesville
MVW - Burlington/Mount Vernon
BLD - Boulder City
BVX - Batesville
BVY - Beverly
BWC - Brawley
BWD - Brownwood
BWG - Bowling Green
BWI - Baltimore
WAH - Wahpeton
BXA - Bogalusa
BXK - Buckeye
NHZ - Brunswick
BYG - Buffalo
BYH - Blytheville
BYI - Burley
BYS - Fort Irwin/Barstow
BBC - Bay City
BZN - Bozeman
CAD - Cadillac
CAE - Columbia
CIG - Craig
CAK - Akron
CAO - Clayton
CAR - Caribou
CBE - Cumberland
CBF - Council Bluffs
CBK - Colby
CBM - Columbus
CCB - Upland
CCR - Concord
CCY - Charles City
LLX - Lyndonville
CDC - Cedar City
CDH - Camden
CDK - Cedar Key
CDN - Camden
CDR - Chadron
CDS - Childress
CDW - Caldwell
CEA - Wichita
CEC - Crescent City
CEF - Springfield/Chicopee
CEU - Clemson
CEV - Connersville
CEW - Crestview
CEY - Murray
CEZ - Cortez
CFD - Bryan
TZC - Caro
CFT - Clifton/Morenci
CFV - Coffeyville
CGE - Cambridge
CGF - Cleveland
CGI - Cape Girardeau
CGS - College Park
CGZ - Casa Grande
CHA - Chattanooga
CHK - Chickasha
CHO - Charlottesville
CHS - Charleston
CIC - Chico
CID - Cedar Rapids
CIN - Carroll
CIR - Cairo
CIU - Sault Ste Marie
CKA - Cherokee
CKB - Clarksburg
GRM - Grand Marais
CKM - Clarksdale
CKN - Crookston
CKV - Clarksville
CLE - Cleveland
CLI - Clintonville
CLK - Clinton
CLL - College Station
CLM - Port Angeles
CLR - Calipatria
CLS - Chehalis
CLT - Charlotte
CLW - Clearwater
CMH - Columbus
CMI - Champaign/Urbana
CMX - Hancock
CMY - Sparta
CNH - Claremont
CNK - Concordia
CNM - Carlsbad
CNO - Chino
CNU - Chanute
CNW - Waco
CNY - Moab
COD - Cody
COE - Coeur d'Alene
COF - Cocoa Beach
COI - Merritt Island
COM - Coleman
CON - Concord
COS - Colorado Springs
COT - Cotulla
COU - Columbia
CPM - Compton
CPR - Casper
CPS - Cahokia/St Louis
HCW - Cheraw
CRE - North Myrtle Beach
CRG - Jacksonville
CRO - Corcoran
CRP - Corpus Christi
CLD - Carlsbad
CRS - Corsicana
CRT - Crossett
CRW - Charleston
CRX - Corinth
CSG - Columbus
CSM - Clinton
CSQ - Creston
CSV - Crossville
CTB - Cut Bank
CTY - Cross City
CTZ - Clinton
CUB - Columbia
CUH - Cushing
CVG - Hebron
HLI - Hollister
CKK - Ash Flat
CVN - Clovis
CVO - Corvallis
CVS - Clovis
CWA - Mosinee
KIP - Wichita Falls
CWF - Lake Charles
CWI - Clinton
CXL - Calexico
CXO - Houston
CSN - Carson City
HAR - Harrisburg
CYS - Cheyenne
CZT - Carrizo Springs
DAA - Fort Belvoir
DAB - Daytona Beach
DAG - Daggett
DAL - Dallas
DAN - Danville
DAY - Dayton
DBN - Dublin
DBQ - Dubuque
DCA - Washington
DCU - Decatur
DDC - Dodge City
DEC - Decatur
DEH - Decorah
DEN - Denver
DET - Detroit
DFI - Defiance
DFW - Dallas-Fort Worth
DGL - Douglas
DGW - Douglas
DHN - Dothan
DHT - Dalhart
DIK - Dickinson
DKK - Dunkirk
DLL - Dillon
DLF - Del Rio
DLH - Duluth
DLN - Dillon
DLS - The Dalles
DMA - Tucson
DMN - Deming
DMO - Sedalia
DNL - Augusta
DNN - Dalton
DNS - Denison
DNV - Danville
DOV - Dover
DPA - Chicago/West Chicago
DPG - Dugway Proving Ground
DRA - Mercury
DRI - De Ridder
DRE - Drummond Island
DRO - Durango
DRT - Del Rio
DSM - Des Moines
DSV - Dansville
DTA - Delta
DTL - Detroit Lakes
DTN - Shreveport
DSI - Destin
DTW - Detroit
DUA - Durant
DUC - Duncan
DUG - Douglas Bisbee
DUJ - Dubois
DVL - Devils Lake
DVN - Davenport
NOT - Novato
NSL - Slayton
DVT - Phoenix
DWH - Houston
DXR - Danbury
DYL - Doylestown
DYS - Abilene
CCG - Crane
BGQ - Big Lake
BGT - Bagdad
EAN - Wheatland
EAR - Kearney
EAT - Wenatchee
EAU - Eau Claire
EBS - Webster City
ECG - Elizabeth City
ECP - Panama City Beach
ECS - Newcastle
EDE - Edenton
ETS - Enterprise
EDW - Edwards
EED - Needles
EEN - Keene
EFD - Houston
EFK - Newport
EFW - Jefferson
EGE - Eagle
EGI - Crestview
EGV - Eagle River
EKA - Eureka
EKI - Elkhart
EKN - Elkins
EKO - Elko
EKX - Elizabethtown
ELA - Eagle Lake
ELD - El Dorado
ELK - Elk City
ELM - Elmira/Corning
ELN - Ellensburg
LYU - Ely
ELP - El Paso
ELY - Ely
ELZ - Wellsville
EMM - Kemmerer
EMP - Emporia
EMT - El Monte
END - Enid
ENL - Centralia
ENV - Wendover
ENW - Kenosha
EOK - Keokuk
EOS - Neosho
EPH - Ephrata
EDK - El Dorado
ERI - Erie
ERR - Errol
ERV - Kerrville
ESC - Escanaba
ESF - Alexandria
ESN - Easton
EST - Estherville
ESW - Easton
ETB - West Bend
ETN - Eastland
EUF - Eufaula
EUG - Eugene
EVM - Eveleth
EVV - Evansville
EVW - Evanston
EWB - New Bedford
EWK - Newton
EWN - New Bern
EWR - Newark
EYW - Key West
FAF - Fort Eustis
FAM - Farmington
FAR - Fargo
FAT - Fresno
FAY - Fayetteville
FBG - Fort Bragg
FBL - Faribault
FBR - Fort Bridger
FBY - Fairbury
FCH - Fresno
FCM - Minneapolis
FCS - Fort Carson
FCY - Forrest City
FDK - Frederick
FDR - Frederick
FDY - Findlay
FEP - Freeport
FET - Fremont
FFA - Kill Devil Hills
FFL - Fairfield
FFM - Fergus Falls
FFO - Dayton
FFT - Frankfort
MSC - Mesa
FHB - Fernandina Beach
FRD - Friday Harbor
FHU - Fort Huachuca Sierra Vista
FKL - Franklin
FKN - Franklin
FLD - Fond du Lac
FLG - Flagstaff
FLL - Fort Lauderdale
FLO - Florence
FLP - Flippin
FLV - Fort Leavenworth
FLX - Fallon
FME - Fort Meade(Odenton)
FMH - Falmouth
FMN - Farmington
FMY - Fort Myers
FNL - Fort Collins/Loveland
FNT - Flint
FOD - Fort Dodge
FOE - Topeka
FOK - Westhampton Beach
FIL - Fillmore
FPR - Fort Pierce
FRG - Farmingdale
FRH - French Lick
FRI - Fort Riley(Junction City)
FRM - Fairmont
FRR - Front Royal
FSD - Sioux Falls
FSI - Fort Sill
FSK - Fort Scott
FSM - Fort Smith
FST - Fort Stockton
FSU - Fort Sumner
FMS - Fort Madison
FTK - Fort Knox
FTW - Fort Worth
FTY - Atlanta
FUL - Fullerton
WFK - Frenchville
FWA - Fort Wayne
FXE - Fort Lauderdale
FXY - Forest City
FYM - Fayetteville
FYV - Fayetteville
GAB - Gabbs
GAD - Gadsden
GAG - Gage
GAI - Gaithersburg
GBD - Great Bend
GBG - Galesburg
GBR - Great Barrington
GCC - Gillette
JDA - John Day
GCK - Garden City
GCN - Grand Canyon
GCY - Greeneville
GDM - Gardner
GDV - Glendive
GDW - Gladwin
GDY - Grundy
GED - Georgetown
GEG - Spokane
GEY - Greybull
GFK - Grand Forks
GFL - Glens Falls
GGE - Georgetown
GGG - Longview
GGW - Glasgow
GHM - Centerville
IDH - Grangeville
GIF - Winter Haven
GJT - Grand Junction
MEJ - Meadville
GKT - Sevierville
GLD - Goodland
GLE - Gainesville
GLH - Greenville
GLR - Gaylord
GLS - Galveston
GLW - Glasgow
GMU - Greenville
GNG - Gooding
GNT - Grants
GNV - Gainesville
GOK - Guthrie
GON - Groton (New London)
FCA - Kalispell
GPT - Gulfport
GPZ - Grand Rapids
GQQ - Galion
GRB - Green Bay
GRD - Greenwood
GRE - Greenville
GRF - Fort Lewis/Tacoma
GRI - Grand Island
GRK - Fort Hood/Killeen
GRN - Gordon
GRR - Grand Rapids
GSB - Goldsboro
GSH - Goshen
GSO - Greensboro
GSP - Greenville
GTB - Fort Drum
GTF - Great Falls
GTG - Grantsburg
GTR - Columbus/W Point/Starkville
GUC - Gunnison
GUP - Gallup
GUS - Peru
GUY - Guymon
GVL - Gainesville
GVT - Greenville
GWO - Greenwood
GWS - Glenwood Springs
GXY - Greeley
GDC - Greenville
PNX - Sherman/Denison
GYR - Goodyear
GYY - Gary
HAB - Hamilton
HAF - Half Moon Bay
HAI - Three Rivers
HAO - Hamilton
HBG - Hattiesburg
HBR - Hobart
HDE - Holdrege
HDN - Hayden
HEE - Helena/West Helena
MNZ - Manassas
HEZ - Natchez
HFD - Hartford
HFF - Camp Mackall
HGR - Hagerstown
HHR - Hawthorne
HUJ - Hugo
HIB - Hibbing
HIE - Whitefield
HIF - Ogden
HII - Lake Havasu City
HIO - Portland
HKA - Blytheville
HKS - Jackson
HKY - Hickory
HLB - Batesville
HLC - Hill City
HLG - Wheeling
HLM - Holland
HLN - Helena
HLR - Fort Hood(Killeen)
HMN - Alamogordo
HMT - Hemet
HNB - Huntingburg
HSH - Las Vegas
HOB - Hobbs
HON - Huron
HOP - Fort Campbell/Hopkinsville
HOT - Hot Springs
HOU - Houston
HPN - White Plains
HPT - Hampton
HPY - Baytown
HQM - Hoquiam
HES - Hermiston
HRL - Harlingen
HRO - Harrison
HSB - Harrisburg
HNC - Hatteras
HSI - Hastings
HSP - Hot Springs
HST - Homestead
HSV - Huntsville
HTH - Hawthorne
HTL - Houghton Lake
HTO - East Hampton
HTS - Huntington
HTW - Chesapeake/Huntington Wva
HUA - Redstone Arsnl Huntsville
HUF - Terre Haute
HUL - Houlton
HUM - Houma
HUT - Hutchinson
HVE - Hanksville
HVN - New Haven
HVR - Havre
HVS - Hartsville
HWD - Hayward
HWO - Hollywood
WSH - Shirley
HHH - Hilton Head Island
HYA - Hyannis
HYR - Hayward
HYS - Hays
HZL - Hazleton
JFN - Ashtabula
IAB - Wichita
IAD - Dulles
IAG - Niagara Falls
IAH - Houston
ICL - Clarinda
ICT - Wichita
IDA - Idaho Falls
IDG - Ida Grove
IDI - Indiana
IDP - Independence
XPR - Pine Ridge
IFA - Iowa Falls
IFP - Bullhead City
IGM - Kingman
IJX - Jacksonville
IKK - Kankakee
ILE - Killeen
ILG - Wilmington
ILM - Wilmington
ILN - Wilmington
IML - Imperial
IMM - Immokalee
MDN - Madison
IMT - Iron Mountain Kingsford
IND - Indianapolis
INK - Wink
INL - International Falls
INS - Indian Springs
INT - Winston Salem
INW - Winslow
IOW - Iowa City
IPL - Imperial
IPT - Williamsport
IRK - Kirksville
IRS - Sturgis
ISM - Orlando
ISN - Williston
ISO - Kinston
ISP - Islip
ISQ - Manistique
ISW - Wisconsin Rapids
ITH - Ithaca
AZA - Phoenix
IWD - Ironwood
ISS - Wiscasset
IWS - Houston
JCI - Olathe
IYK - Inyokern
SQA - Santa Ynez
FRY - Fryeburg
JAC - Jackson
JAN - Jackson
JAS - Jasper
JAX - Jacksonville
JBR - Jonesboro
JCT - Junction
JDN - Jordan
JEF - Jefferson City
JFK - New York
JHW - Jamestown
GUF - Gulf Shores
JLN - Joplin
JMS - Jamestown
JOT - Joliet
USA - Concord
JKV - Jacksonville
JST - Johnstown
JVL - Janesville
JXN - Jackson
KIC - King City
KLS - Kelso
KNB - Kanab
BXS - Borrego Springs
LAA - Lamar
LAF - Lafayette
LAL - Lakeland
LAM - Los Alamos
LAN - Lansing
LAR - Laramie
LAS - Las Vegas
LAW - Lawton
LAX - Los Angeles
LBB - Lubbock
LBE - Latrobe
LBF - North Platte
LBL - Liberal
LBT - Lumberton
LJN - Angleton/Lake Jackson
LCH - Lake Charles
LCI - Laconia
LCK - Columbus
LCQ - Lake City
LDJ - Linden
LDM - Ludington
LEB - Lebanon
LEE - Leesburg
LEM - Lemmon
LEW - Auburn/Lewiston
LEX - Lexington
LFI - Hampton
LFK - Lufkin
LFT - Lafayette
LGA - New York
LGB - Long Beach
LGC - Lagrange
LGD - La Grande
LGF - Yuma Proving Ground(Yuma)
LGU - Logan
LHV - Lock Haven
LIY - Fort Stewart(Hinesville)
LFN - Louisburg
LIC - Limon
LIT - Little Rock
LKP - Lake Placid
LOW - Louisa
LKV - Lakeview
CHL - Challis
LMS - Louisville
LMT - Klamath Falls
LNA - West Palm Beach
LND - Lander
LNK - Lincoln
LNN - Willoughby
LNP - Wise
LNR - Lone Rock
LNS - Lancaster
LOL - Lovelock
BBX - Philadelphia
LOT - Chicago/Romeoville
LOU - Louisville
LOZ - London
LPC - Lompoc
LQK - Pickens
LRD - Laredo
LRF - Jacksonville
LRJ - Le Mars
LRU - Las Cruces
LSB - Lordsburg
LSE - La Crosse
LSF - Fort Benning(Columbus)
LSK - Lusk
LSN - Los Banos
LSV - Las Vegas
LTS - Altus
LUF - Glendale
LUK - Cincinnati
LUL - Laurel
LVK - Livermore
LVL - Lawrenceville
LVM - Livingston
LVS - Las Vegas
LWB - Lewisburg
LWC - Lawrence
LWL - Wells
LWM - Lawrence
LWS - Lewiston
LWT - Lewistown
LWV - Lawrenceville
LXN - Lexington
LXV - Leadville
LYH - Lynchburg
LYO - Lyons
LZU - Lawrenceville
MAC - Macon
MAE - Madera
MAF - Midland
MAW - Malden
MBG - Mobridge
MBL - Manistee
DXE - Madison
MBS - Saginaw
MBY - Moberly
MCB - Mc Comb
MCC - Sacramento
MCD - Mackinac Island
MCE - Merced
MCF - Tampa
MCI - Kansas City
MCK - Mc Cook
MCN - Macon
MCO - Orlando
MCW - Mason City
MDD - Midland
MDH - Carbondale/Murphysboro
XMD - Madison
MDT - Harrisburg
MDW - Chicago
MDF - Medford
MXE - Maxton
MEI - Meridian
MEM - Memphis
MER - Merced
MEV - Minden
MFD - Mansfield
MFE - Mc Allen
MFI - Marshfield
MFR - Medford
MFV - Melfa
MGC - Michigan City
MGE - Marietta
MGJ - Montgomery
MGM - Montgomery
MGR - Moultrie
MGW - Morgantown
MGY - Dayton
MHE - Mitchell
MHK - Manhattan
MHL - Marshall
MHR - Sacramento
MHT - Manchester
MHV - Mojave
MIA - Miami
MIB - Minot
MIC - Minneapolis
MIE - Muncie
MIO - Miami
MIT - Shafter
MIV - Millville
MIW - Marshalltown
MJQ - Jackson
MJX - Toms River
MKC - Kansas City
MKE - Milwaukee
MKG - Muskegon
MKL - Jackson
MKO - Muskogee
MKT - Mankato
MRK - Marco Island
MLB - Melbourne
MLC - Mc Alester
MLD - Malad City
MIQ - Omaha
MLF - Milford
MLI - Moline
MLJ - Milledgeville
MLS - Miles City
MLT - Millinocket
MLU - Monroe
MMH - Mammoth Lakes
MMI - Athens
MML - Marshall
MMS - Marks
MMT - Eastover
MMU - Morristown
MNM - Menominee
MNN - Marion
MOB - Mobile
MOD - Modesto
MOP - Mount Pleasant
MOR - Morristown
MOT - Minot
MOX - Morris
RMY - Mariposa
MPJ - Morrilton
MPO - Mount Pocono
MPR - Mc Pherson
MPV - Barre/Montpelier
MPZ - Mount Pleasant
MQB - Macomb
MEO - Manteo
CTH - Coatesville
MQW - Mc Rae
MQY - Smyrna
MRB - Martinsburg
MRC - Columbia/Mount Pleasant
MRF - Marfa
MRN - Morganton
MRY - Monterey
MSL - Muscle Shoals
MSN - Madison
MSO - Missoula
MSP - Minneapolis
MSS - Massena
MSV - Monticello
MSY - New Orleans
MTC - Mount Clemens
MTH - Marathon
MTJ - Montrose
MTN - Baltimore
MTO - Mattoon/Charleston
MTP - Montauk
MTW - Manitowoc
MUI - Fort Indiantown Gap(Annville)
MUL - Moultrie
MUO - Mountain Home
MUT - Muscatine
MVC - Monroeville
MVE - Montevideo
MVL - Morrisville
MVN - Mount Vernon
MVY - Martha's Vineyard
MWA - Marion
MWC - Milwaukee
MWH - Moses Lake
MWL - Mineral Wells
MWM - Windom
MWO - Middletown
MXA - Manila
MXF - Montgomery
MXO - Monticello
MYF - San Diego
MYL - Mc Call
MYR - Myrtle Beach
MYV - Marysville
MZJ - Marana
MZZ - Marion
NBG - New Orleans
NHX - Foley
DGN - Dahlgren
NEL - Lakehurst
NEN - Jacksonville
NEW - New Orleans
NFL - Fallon
FWH - Fort Worth
NGP - Corpus Christi
NGU - Norfolk
NGW - Corpus Christi
NHK - Patuxent River
NIP - Jacksonville
NJK - El Centro
NKX - San Diego
NLC - Lemoore
NPA - Pensacola
NQA - Millington
NQI - Kingsville
NQX - Key West
NRB - Mayport
NRS - Imperial Beach
NSE - Milton
NTD - Point Mugu
NTU - Virginia Beach
NUN - Pensacola
NUQ - Mountain View
NUW - Oak Harbor
NVD - Nevada
NYG - Quantico
YUM - Yuma
NZY - San Diego
NVN - Beckwourth
ODC - Oakdale
EYR - Yerington
OAJ - Jacksonville
OAK - Oakland
OAR - Marina
OBE - Okeechobee
OCF - Ocala
OCH - Nacogdoches
OCW - Washington
OEO - Osceola
OFF - Omaha
OFK - Norfolk
OGA - Ogallala
OGB - Orangeburg
OGD - Ogden
OGS - Ogdensburg
OIC - Norwich
OJC - Olathe
OCN - Oceanside
OKC - Oklahoma City
ODW - Oak Harbor
OKK - Kokomo
OKM - Okmulgee
OKS - Oshkosh
WGO - Winchester
OLD - Old Town
OLE - Olean
OLF - Wolf Point
OLM - Olympia
OLS - Nogales
OLU - Columbus
OLV - Olive Branch
OLY - Olney-Noble
OMA - Omaha
OMK - Omak
ONA - Winona
ONL - O'Neill
ONM - Socorro
ONO - Ontario
ONP - Newport
ONT - Ontario
ONY - Olney
OOA - Oskaloosa
OPF - Miami
OPL - Opelousas
NCO - North Kingstown
ORD - Chicago
ORF - Norfolk
ORH - Worcester
ORL - Orlando
ESD - Eastsound
MPS - Mount Pleasant
OSC - Oscoda
OSH - Oshkosh
OSU - Columbus
OSX - Kosciusko
OTG - Worthington
OTH - North Bend
OTM - Ottumwa
OUN - Norman
OVE - Oroville
OWA - Owatonna
OWB - Owensboro
OWD - Norwood
OWK - Norridgewock
OCE - Ocean City
OXC - Oxford
OXD - Oxford
OXR - Oxnard
STQ - St Marys
OZA - Ozona
OZR - Fort Rucker/Ozark
BSQ - Bisbee
HBK - Holbrook
CWX - Willcox
PAE - Everett
PAH - Paducah
PAM - Panama City
PJB - Payson
PAO - Palo Alto
PBF - Pine Bluff
PBG - Plattsburgh
PBI - West Palm Beach
PVL - Pikeville
PCD - Prairie Du Chien
PDK - Atlanta
PDT - Pendleton
PDX - Portland
PEQ - Pecos
PFC - Pacific City
PFN - Panama City
PGA - Page
PGD - Punta Gorda
PGR - Paragould
PGV - Greenville
PHD - New Philadelphia
PHF - Newport News
ADR - Andrews
PHK - Pahokee
PHL - Philadelphia
PHN - Port Huron
PHP - Philip
PHT - Paris
PHX - Phoenix
PIA - Peoria
PIB - Hattiesburg/Laurel
PIE - St Petersburg-Clearwater
PIH - Pocatello
PIM - Pine Mountain
PIR - Pierre
PIT - Pittsburgh
PKB - Parkersburg
PKD - Park Rapids
PKF - Park Falls
PLK - Point Lookout
PLN - Pellston
PLR - Pell City
PMB - Pembina
PMD - Palmdale
PMH - Portsmouth
PPM - Pompano Beach
PWY - Pinedale
PNC - Ponca City
PNE - Philadelphia
PNN - Princeton
PNS - Pensacola
POB - Fayetteville
POC - La Verne
POE - Fort Polk
POF - Poplar Bluff
POH - Pocahontas
POU - Poughkeepsie
POY - Powell
PPA - Pampa
PPF - Parsons
LPO - La Porte
PQI - Presque Isle
PGL - Pascagoula
PRB - Paso Robles
PRC - Prescott
PRO - Perry
PRX - Paris
PSB - Philipsburg
PSC - Pasco
PSF - Pittsfield
PSK - Dublin
PSM - Portsmouth
PSN - Palestine
PGO - Pagosa Springs
PSP - Palm Springs
PSX - Palacios
PTB - Petersburg
PTK - Pontiac
PTN - Patterson
PTS - Pittsburg
PTT - Pratt
PTV - Porterville
PTW - Pottstown
PUB - Pueblo
PUC - Price
PUW - Pullman/Moscow
PVC - Provincetown
PVD - Providence
PVF - Placerville
PVU - Provo
PVW - Plainview
PWA - Oklahoma City
PWD - Plentywood
PWM - Portland
PWT - Bremerton
PYM - Plymouth
RAC - Racine
RAL - Riverside
RAP - Rapid City
RBD - Dallas
RBG - Roseburg
RBL - Red Bluff
RBW - Walterboro
RCA - Rapid City
RCK - Rockdale
RCR - Rochester
RCT - Reed City
RDD - Redding
RDG - Reading
RDM - Redmond
RDR - Grand Forks
RDU - Raleigh/Durham
REO - Rome
RFD - Chicago/Rockford
RFG - Refugio
RHI - Rhinelander
RHV - San Jose
RIC - Richmond
RID - Richmond
RIF - Richfield
RIL - Rifle
RIR - Riverside/Rubidoux/
RIV - Riverside
RIW - Riverton
RKD - Rockland
RKP - Rockport
RKR - Poteau
RKS - Rock Springs
RKW - Rockwood
RLD - Richland
RME - Rome
RMG - Rome
RNC - Mc Minnville
RND - Universal City
RNH - New Richmond
RNO - Reno
RNT - Renton
ROA - Roanoke
ROC - Rochester
ROG - Rogers
ROW - Roswell
ROX - Roseau
RIE - Rice Lake
RPX - Roundup
WBR - Big Rapids
RQO - El Reno
RRL - Merrill
RRT - Warroad
RSL - Russell
RSN - Ruston
RST - Rochester
RSW - Fort Myers
RTN - Raton
SRW - Salisbury
RUT - Rutland
RED - Reedsville
RVS - Tulsa
RWF - Redwood Falls
RWI - Rocky Mount
RWL - Rawlins
RXE - Rexburg
RNZ - Rensselaer
RZZ - Roanoke Rapids
AHM - Ashland
BDY - Bandon
SUO - Sunriver
VSK - Kennewick
SAA - Saratoga
SAC - Sacramento
SAD - Safford
SAF - Santa Fe
SAN - San Diego
SAR - Sparta
SAS - Salton City
SAT - San Antonio
SAV - Savannah
MQT - Marquette
SBA - Santa Barbara
SBD - San Bernardino
SBM - Sheboygan
SBN - South Bend
SBP - San Luis Obispo
SBS - Steamboat Springs
SBX - Shelby
SBY - Salisbury
SCB - Scribner
SCH - Schenectady
SCK - Stockton
SDF - Louisville
SCF - Scottsdale
SDM - San Diego
SDY - Sidney
SEA - Seattle
SEE - San Diego/El Cajon
SEF - Sebring
SEG - Selinsgrove
SEM - Selma
SEP - Stephenville
SER - Seymour
SDX - Sedona
SFB - Orlando
SFF - Spokane
SFM - Sanford
SFO - San Francisco
SFZ - Pawtucket
SGF - Springfield
SGH - Springfield
UST - St Augustine
SGR - Houston
SGT - Stuttgart
SGU - St George
SHD - Staunton/Waynesboro/Harrisonburg
SHN - Shelton
SHR - Sheridan
SHV - Shreveport
SIK - Sikeston
SIV - Sullivan
SIY - Montague
SJC - San Jose
SJN - St Johns
SJT - San Angelo
SKA - Spokane
SKF - San Antonio
TSM - Taos
SLB - Storm Lake
SLC - Salt Lake City
SLE - Salem
SLG - Siloam Springs
SLK - Saranac Lake
SLN - Salina
SLO - Salem
SLR - Sulphur Springs
SMD - Fort Wayne
SME - Somerset
SMF - Sacramento
SMN - Salmon
SMO - Santa Monica
SUM - Sumter
SMX - Santa Maria
SNA - Santa Ana
SNK - Snyder
SNL - Shawnee
SNS - Salinas
SNY - Sidney
SOP - Pinehurst/Southern Pines
SOW - Show Low
SPA - Spartanburg
SPF - Spearfish
SPG - St Petersburg
SPI - Springfield
SPS - Wichita Falls
SPW - Spencer
SQI - Sterling/Rockfalls
SQL - San Carlos
SRC - Searcy
SRQ - Sarasota/Bradenton
RUI - Ruidoso
SSC - Sumter
SSF - San Antonio
SSI - Brunswick
STC - St Cloud
STE - Stevens Point
STJ - St Joseph
STK - Sterling
STL - St Louis
STP - St Paul
STS - Santa Rosa
SUA - Stuart
SUD - Stroud
SUE - Sturgeon Bay
SUN - Hailey
SUS - St Louis
SUU - Fairfield
SUW - Superior
SUX - Sioux City
SVC - Silver City
SVE - Susanville
SVH - Statesville
SVN - Savannah
SWF - Newburgh
SWO - Stillwater
SWW - Sweetwater
SYI - Shelbyville
SYN - Stanton
SYR - Syracuse
SYV - Sylvester
SZL - Knob Noster
SZN - Santa Barbara
SZP - Santa Paula
TAD - Trinidad
TBN - Fort Leonard Wood
TBR - Statesboro
TCC - Tucumcari
TCL - Tuscaloosa
TCM - Tacoma
TCS - Truth Or Consequences
TDO - Toledo
TDW - Amarillo
TDZ - Toledo
TEB - Teterboro
TEX - Telluride
THA - Tullahoma
THM - Thompson Falls
THP - Thermopolis
THV - York
TIK - Oklahoma City
TIW - Tacoma
TIX - Titusville
KNT - Kennett
TLH - Tallahassee
TLR - Tulare
TMA - Tifton
TMB - Miami
OTK - Tillamook
ASQ - Austin
TNP - Twentynine Palms
TNT - Miami
TNU - Newton
XSD - Tonopah
TOA - Torrance
TOC - Toccoa
TOI - Troy
TOL - Toledo
TOP - Topeka
TOR - Torrington
TPA - Tampa
TPF - Tampa
TPH - Tonopah
TPL - Temple
TRI - Bristol/Johnson/Kingsport
TKF - Truckee
TRL - Terrell
TRM - Palm Springs
TRX - Trenton
TSP - Tehachapi
TTD - Portland
TTN - Trenton
TUL - Tulsa
TUP - Tupelo
TUS - Tucson
TVC - Traverse City
TVF - Thief River Falls
TVI - Thomasville
TVL - South Lake Tahoe
TWF - Twin Falls
TXK - Texarkana
TYZ - Taylor
TYR - Tyler
TYS - Knoxville
BFG - Glen Canyon Natl Rec Area
RVR - Green River
ICS - Cascade
UBS - Columbus
UCY - Union City
UDD - Palm Springs
UES - Waukesha
UGN - Chicago/Waukegan
UIL - Quillayute
UIN - Quincy
IKB - North Wilkesboro
UKI - Ukiah
UKT - Quakertown
ULM - New Ulm
ATO - Athens/Albany
UNU - Juneau
SCE - State College
UOS - Sewanee
UOX - Oxford
UTM - Tunica
HTV - Huntsville
NPT - Newport
UVA - Uvalde
RKH - Rock Hill
VAD - Valdosta
LLY - Mount Holly
VBG - Lompoc
VCT - Victoria
VCV - Victorville
VDI - Vidalia
VEL - Vernal
VGT - Las Vegas
VHN - Van Horn
VIH - Rolla/Vichy
VIS - Visalia
VJI - Abingdon
VKS - Vicksburg
VKX - Friendly
VLA - Vandalia
VLD - Valdosta
VNC - Venice
VNY - Van Nuys
VOK - Camp Douglas
VPS - Valparaiso
VPZ - Valparaiso
VQQ - Jacksonville
VRB - Vero Beach
VSF - Springfield
VTN - Valentine
VYS - Peru
WAL - Wallops Island
WAY - Waynesburg
WBW - Wilkes-Barre
WDG - Enid
WDR - Winder
WHP - Los Angeles
WJF - Lancaster
WLD - Winfield/Arkansas City
WLW - Willows
WMC - Winnemucca
WRB - Warner Robins
WRI - Wrightstown
WRL - Worland
WSD - White Sands
WST - Westerly
WVI - Watsonville
WVL - Waterville
WWD - Wildwood
WWR - Woodward
WYS - West Yellowstone
XNA - Fayetteville/Springdale/
YIP - Detroit
YKM - Yakima
YKN - Yankton
YNG - Youngstown/Warren
ZPH - Zephyrhills
ZZV - Zanesville
TIA - Tirana
BOJ - Burgas
GOZ - Gorna Oryahovitsa
HKV - Haskovo
JAM - Yambol
PDV - Plovdiv
PVN - Dolna Mitropoliya
SOF - Sofia
SLS - Silistra
SZR - Stara Zagora
TGV - Targovishte
VID - Vidin
VAR - Varna
ECN - Nicosia
LCA - Larnarca
PFO - Paphos
DBV - Dubrovnik
LSZ - Losinj
OSI - Osijek
PUY - Pula
RJK - Rijeka
BWK - Brac Island
SPU - Split
ZAG - Zagreb
ZAD - Zadar
ABC - Albacete
ALC - Alicante
LEI - Almeria
OVD - Ranon
ODB - Cordoba
BIO - Bilbao
RGS - Burgos
BCN - Barcelona
BJZ - Badajoz
CDT - Calamocha
CDT - Castellon de La Plana
LCG - Culleredo
ECV - Madrid
ILD - Lleida
GRO - Girona
GRX - Granada
HSK - Monflorite/Alcala del Obispo
IBZ - Ibiza
XRY - Jerez de la Forntera
MJV - San Javier
QSA - Sabadell
LEN - Leon
RJL - Logrono
MAD - Madrid
HEV - Gibraleon
AGP - Malaga
MAH - Menorca Island
RMU - Corvera
OZP - Moron
PMI - Palma De Mallorca
PNA - Pamplona
REU - Reus
ROZ - Rota
SLM - Salamanca
EAS - Hondarribia
SCQ - Santiago de Compostela
LEU - Montferrer / Castellbo
TOJ - Madrid
VLC - Valencia
VLL - Valladolid
VIT - Alava
VGO - Vigo
SDR - Santander
ZAZ - Zaragoza
SVQ - Sevilla
DPE - Dieppe
CQF - Marck
XCP - Compiegne
XLN - Laon-Chambry
XSJ - Peronne/Saint-Quentin
XDK - Les Moeres
BYF - Albert/Bray
LTQ - Le Touquet-Paris-Plage
XVS - Valenciennes/Denain
QAM - Amiens/Glisy
AGF - Agen/La Garenne
BOD - Bordeaux/Merignac
EGC - Bergerac/Roumaniere
CNG - Cognac/Chateaubernard
LRH - La Rochelle/Ile de Re
PIS - Poitiers/Biard
MCU - Montlucon/Gueret
LIG - Limoges/Bellegarde
XMJ - Mont-de-Marsan
NIT - Niort/Souche
TLS - Toulouse/Blagnac
PUF - Pau/Pyrenees (Uzein)
LDE - Tarbes/Lourdes/Pyrenees
ANG - Angouleme/Brie/Champniers
BVE - Brive-la-Gaillarde
PGX - Perigueux/Bassillac
XDA - Perigueux
BIQ - Biarritz/Anglet/Bayonne
XCX - Biarritz
ZAO - Cahors/Lalbenque
XGT - Cahors
XAC - Arcachon/La Teste-de-Buch
LBI - Albi/Le Sequestre
DCM - Castres/Mazamet
RDZ - Rodez/Marcillac
RYN - Royan/Medis
XMW - Montauban
XLR - Libourne/Artigues-de-Lussac
RCO - Rochefort/Saint-Agnant
XSL - Rochefort
XTB - Rochefort
IDY - Ile d'Yeu
CMR - Colmar/Houssen
XBV - Beaune/Challanges
DLE - Dole/Tavaux
XVN - Verdun/Le Rozelier
MVV - Verdun
OBS - Aubenas/Ardeche Meridional
LPY - Le Puy/Loudes
XBK - Bourg/Ceyzeriat
AHZ - Bourg
XMU - Moulins/Montbeugny
ETZ - Metz / Nancy
ANE - Angers/Marce
XAV - Angers
BIA - Bastia/Poretta
CLY - Calvi/Sainte-Catherine
FSC - Figari Sud-Corse
AJA - Ajaccio/Napoleon Bonaparte
PRP - Propriano
SOZ - Solenzara
MFX - Ajaccio
AUF - Auxerre/Branches
CMF - Chambery/Aix-les-Bains
CFE - Clermont-Ferrand/Auvergne
BOU - Bourges
QNJ - Annemasse
CVF - Courcheval
LYS - Lyon
QNX - Macon/Charnay
SYT - Saint-Yan
RNE - Roanne/Renaison
NCY - Annecy/Meythet
XMK - Annecy
GNB - Grenoble/Saint-Geoirs
VAF - Valence/Chabeuil
VHY - Vichy/Charmeil
AUR - Aurillac
CHR - Chateauroux/Deols
LYN - Lyon/Bron
QXB - Lyon
CEQ - Cannes/Mandelieu
EBU - Saint-Etienne/Boutheon
QIE - Istres/Le Tube
CCF - Carcassonne/Salvaza
MRS - Marseille
NCE - Nice
XOG - Orange/Caritat
PGF - Perpignan/Rivesaltes
CTT - Le Castellet
BAE - Le Castellet
XAS - Ales/Deaux
MPL - Montpellier/Mediterranee
BZR - Beziers/Vias
AVN - Avignon/Caumont
GAT - Avignon
MEN - Mende/Brenoux
SCP - Mende
BVA - Beauvais/Tille
XSU - Saumur/Saint-Florent
EVX - Evreux/Fauville
XAN - Evreux
LEH - Le Havre/Octeville
XAB - Abbeville (Buigny/Saint-Maclou)
ORE - Orleans/Bricy
XCR - Chalons/Vatry
LSO - Les Sables-d'Olonne
URO - Rouen/Vallee de Seine
XBQ - Blois/Le Breuil
QTJ - Blois
TUF - Tours/Val de Loire (Loire Valley)
CET - Cholet/Le Pontreau
LVA - Laval/Entrammes
ORE - Orleans/Saint-Denis-de-l'Hotel
LBG - Paris
CSF - Creil
CDG - Paris
TNF - Toussus-le-Noble
ORY - Paris
POX - Pontoise
VIY - Villacoublay/Velizy
QYR - Troyes/Barberey
NVS - Nevers/Fourchambault
XCB - Cambrai/Epinoy
XME - Maubeuge/Elesmes
LIL - Lille/Lesquin
HZB - Merville/Calonne
XCZ - Charleville-Mezieres
XVO - Vesoul/Frotey
BES - Brest/Guipavas
CER - Cherbourg/Maupertus
DNR - Dinard/Pleurtuit/Saint-Malo
LBY - La Baule-Escoublac
GFR - Granville
DOL - Deauville
LRT - Lorient/Lann/Bihoue
EDM - La Roche-sur-Yon/Les Ajoncs
LDV - Landivisiau
CFR - Caen/Carpiquet
LME - Le Mans/Arnage
RNS - Rennes/Saint-Jacques
LAI - Lannion
UIP - Quimper/Pluguffan
NTE - Nantes
SBK - Saint-Brieuc/Armor
MXN - Morlaix/Ploujean
VNE - Vannes/Meucon
SNR - Saint-Nazaire/Montoir
QBQ - St Nazaire
BSL - Bale/Mulhouse
DIJ - Dijon/Longvic
MZM - Metz/Frescaty
EPL - Epinal/Mirecourt
BVE - St Dizier
XMF - Montbeliard/Courcelles
ENC - Nancy/Essey
BOR - Belfort
RHE - Reims/Champagne
SXB - Strasbourg
VTL - Luxeuil
TLN - Toulon/Hyeres/Le Palyvestre
FNI - Nimes/Garons
LTT - La Mole
MQC - Miquelon
FSP - Saint-Pierre
PYR - Andravida
AGQ - Agrinion
AXD - Alexandroupolis
HEW - Athens
ATH - Athens
VOL - Nea Anchialos
JKH - Chios Island
PKH - Porto Cheli
JIK - Ikaria Island
IOA - Ioannina
HER - Heraklion
KSO - Kastoria
KIT - Kithira Island
EFL - Kefallinia Island
KZS - Kastelorizo Island
KLX - Kalamata
KGS - Kos Island
AOK - Karpathos Island
CFU - Kerkyra Island
KSJ - Kasos Island
KVA - Kavala
JKL - Kalymnos Island
KZI - Kozani
LRS - Leros Island
LXS - Limnos Island
LRA - Larisa
JMK - Mykonos Island
MLO - Milos Island
MJT - Mytilene
JNX - Naxos Island
PAS - Paros Island
JTY - Astypalaia Island
PVK - Preveza/Lefkada
RHO - Rodes Island
GPA - Patras
CHQ - Souda
JSI - Skiathos
SMI - Samos Island
JSY - Syros Island
SPJ - Sparti
JTR - Santorini Island
JSH - Crete Island
SKU - Skiros Island
SKG - Thessaloniki
ZTH - Zakynthos Island
BUD - Budapest
DEB - Debrecen
MCQ - Miskolc
PEV - Pecs-Pogany
QGY - Gyor
SOB - Sarmellek
TZR - Taszar
QZD - Szeged
QAQ - L'Aquila
CRV - Crotone
BRI - Bari
FOG - Foggia
TAR - Grottaglie
PSR - Pescara
BDS - Brindisi
SUF - Lamezia Terme
CIY - Comiso
CTA - Catania
LMP - Lampedusa
PNL - Pantelleria
PMO - Palermo
REG - Reggio Calabria
TPS - Trapani
BLX - Belluno
CDF - Cortina D'Ampezzo
RAN - Ravenna
ZIA - Trento
AHO - Alghero
DCI - Decimomannu
CAG - Cagliari
OLB - Olbia
FNU - Oristano
TTB - Arbatax
QVA - Varese
QMM - Marina Di Massa
MXP - Milan
BGY - Bergamo
TRN - Torino
ALL - Albenga
GOA - Genova
LIN - Milan
PMF - Parma
QPZ - Piacenza
AOT - Aosta
CUF - Cuneo
AVB - Aviano
BZO - Bolzano
UDN - Udine
BLQ - Bologna
TSF - Treviso
FRL - Forli
VBS - Brescia
TRS - Trieste
RMI - Rimini
VIC - Vicenza
QPA - Padova
VRN - Verona
AOI - Ancona
VCE - Venezia
QZO - Arezzo
LCV - Lucca
QRT - Rieti
SAY - Siena
CIA - Roma
FCO - Rome
QFR - Frosinone
QSR - Salerno
EBA - Marina  Di Campo
QLT - Latina
NAP - Napoli
PSA - Pisa
FLR - Firenze
GRS - Grosetto
PEG - Perugia
LJU - Ljubljana
POW - Portoroz
GTW - Holesov
UHE - Uherske Hradiste
KLV - Karlovy Vary
MKA - Marianske Lazne
OSR - Ostrava
OLO - Olomouc
PED - Pardubice
PRV - Prerov
PRG - Prague
BRQ - Brno
VOD - Vodochoky
ZBE - Zabreh
TLV - Tel Aviv
BEV - Beersheva
ETH - Eilat
ETM - Eilat
EIY - Sapir
HFA - Haifa
RPN - Rosh Pina
KSW - Kiryat Shmona
MIP - Mitzpe Ramon
MTZ - Masada
VTM - Beersheba
VDA - Eilat
MIP - Beersheba
SDV - Tel Aviv
YOT - Yotvata
MLA - Luqa
HOH - Hohenems / Dornbirn
GRZ - Graz
INN - Innsbruck
KLU - Klagenfurt am Worthersee
LNZ - Linz
SZG - Salzburg
VIE - Vienna
SMA - Vila do Porto
BYJ - Beja
BGZ - Braga
CHV - Chaves
CVU - Corvo
FLW - Santa Cruz das Flores
FAO - Faro
GRW - Santa Cruz da Graciosa
HOR - Horta
TER - Lajes
FNC - Funchal
PDL - Ponta Delgada
PIX - Pico Island
OPO - Porto
PXO - Vila Baleira
LIS - Lisbon
SJZ - Velas
BNX - Banja Luka
OMO - Mostar
SJJ - Sarajevo
TZL - Tuzla
ARW - Arad
BCM - Bacau
BAY - Baia Mare
BBU - Bucharest
CND - Constanta
CLJ - Cluj-Napoca
CSB - Caransebes
CRA - Craiova
IAS - Iasi
OMR - Oradea
OTP - Bucharest
SBZ - Sibiu
SUJ - Satu Mare
SCV - Suceava
TCE - Tulcea
TGM - Targu Mures
TSR - Timisoara
GVA - Geneva
QLS - Lausanne
SIR - Sion
LUG - Lugano
BRN - Bern
BXO - Buochs
ZRH - Zurich
MLH - Bale/Mulhouse
ACH - Altenrhein
ESB - Ankara
ANK - Ankara
ADA - Adana
UAB - Adana
AFY - Afyonkarahisar
AYT - Antalya
GZT - Gaziantep
KFS - Kastamonu
KYA - Konya
MZH - Amasya
SSX - Samsun
VAS - Sivas
ONQ - Zonguldak
MLX - Malatya
ASR - Kayseri
TJK - Tokat
DNZ - Denizli
NAV - Nevsehir
ISL - Istanbul
IST - Arnavutkoy
CII - Aydin
BTZ - Bursa
BZI - Balikesir
BDM - Bandirma
CKZ - Canakkale
ESK - Eskisehir
ADB - Izmir
IGL - Izmir
USQ - Usak
YEI - Bursa
DLM - Dalaman
TEQ - Corlu
BXN - Bodrum
AOE - Eskisehir
KZR - Altintas
EZS - Elazig
OGU - Ordu
DIY - Diyarbakir
ERC - Erzincan
ERZ - Erzurum
KSY - Kars
TZX - Trabzon
SFQ - Sanliurfa
VAN - Van
BAL - Batman
MSR - Mus
SXZ - Siirt
NOP - Sinop
KCM - Kahramanmaras
AJI - Agri
ADF - Adiyaman
MQM - Mardin
GNY - Sanliurfa
IGD - Igdir
YKO - Yuksekova
HTY - Hatay
ISE - Isparta
EDO - Edremit
BJV - Bodrum
GZP - Gazipasa
SZF - Samsun
SAW - Istanbul
GKD - Gokceada
BZY - Strymba
KIV - Chisinau
OHD - Ohrid
SKP - Skopje
GIB - Gibraltar
BEG - Belgrad
IVG - Berane
BJY - Batajnica
INI - Nis
QND - Novi Sad
TGD - Podgorica
TIV - Tivat
UZC - Uzice
QWV - Valjevo
ZRE - Zrenjanin
BTS - Bratislava
KSC - Kosice
LUE - Lucenec
PZY - Piestany
POV - Presov
SLD - Sliac
TAT - Poprad
ILZ - Zilina
GDT - Cockburn Town
MDS - Middle Caicos
PIC - Pine Cay
PLS - Providenciales Island
SLX - Salt Cay
EPS - Arroyo Barril
BRX - Barahona
CBJ - Cabo Rojo
AZS - Samana
COZ - Costanza
JBQ - La Isabela
LRM - La Romana
PUJ - Punta Cana
EPS - Samana
POP - Puerto Plata
SNX - Sabana de Mar
SDQ - Santo Domingo
STI - Santiago
CBV - Coban
CIQ - Chiquimula
CMM - Carmelita
CTF - Coatepeque
DON - Dos Lagunas
GUA - Guatemala City
HUG - Huehuetenango
MCR - Melchor de Mencos
PBR - Puerto Barrios
PCG - Paso Caballos
PKJ - Playa Grande
PON - Poptun
AQB - Santa Cruz del Quiche
AAZ - Quezaltenango
RUV - Rubelsanto
LCF - Rio Dulce
RER - Retalhuleu
GSJ - Puerto San Jose
FRS - San Benito
UAX - Uaxactun
AHS - Ahuas
BHG - Brus Laguna
CAA - Catacamas
CYL - Coyoles
CDD - Cauquira
OAN - Olanchito
GAC - El Molino
IRN - Iriona
JUT - Jutigalpa
LCE - La Ceiba
LEZ - La Esperanza
SAP - La Mesa
GJA - Guanaja
PCH - Palacios
PEU - Puerto Lempira
RTB - Roatan Island
SDH - Santa Rosa de Copan
RUY - Ruinas de Copan
XPL - Comayagua
TEA - Tela
TGU - Tegucigalpa
TJI - Trujillo
SCD - Sulaco
UII - Utila Island
OCJ - Ocho Rios
KIN - Kingston
MBJ - Montego Bay
POT - Ken Jones
NEG - Negril
KTP - Tinson Pen
MIJ - Mili Island
ACA - Acapulco
AGU - Aguascalientes
HUX - Huatulco
ACN - Ciudad Acuna
CME - Ciudad del Carmen
CUL - Culiacan
CTM - Chetumal
CEN - Ciudad Obregon
CPE - Campeche
CJS - Ciudad Juarez
CUU - Chihuahua
CVM - Ciudad Victoria
CYW - Celaya
CZM - Cozumel
CUA - Ciudad Constitucion
MMC - Ciudad Mante
DGO - Durango
TPQ - Tepic
GDL - Guadalajara
GYM - Guaymas
GUB - Guerrero Negro
HMO - Hermosillo
CLQ - Colima
SLW - Saltillo
JAL - Xalapa
LZC - Lazaro Cardenas
LMM - Los Mochis
BJX - Silao
LAP - La Paz
LTO - Loreto
MAM - Matamoros
MID - Merida
MUG - Mulege
MXL - Mexicali
MLM - Morelia
MTT - Minatitlan
MEX - Mexico City
MTY - Monterrey
MZT - Mazatlan
NLD - Nuevo Laredo
OAX - Oaxaca
PAZ - Poza Rica
PBC - Puebla
PPE - Puerto Penasco
PCO - La Ribera
PVR - Puerto Vallarta
PXM - Puerto Escondido
QRO - Queretaro
REX - Reynosa
SJD - San Jose del Cabo
NLU - Santa Lucia
SLP - San Luis Potosi
TRC - Torreon
TGZ - Tuxtla Gutierrez
TIJ - Tijuana
TAM - Tampico
TLC - Toluca
TAP - Tapachula
CUN - Cancun
VSA - Villahermosa
VER - Veracruz
ZCL - Zacatecas
ZIH - Ixtapa
ZLO - Manzanillo
BEF - Bluefileds
BZA - Bonanza
RNI - Corn Island
MGA - Managua
NVG - Nueva Guinea
PUZ - Puerto Cabezas
RFS - La Rosita
NCR - San Carlos
SIU - Siuna
WSP - Waspam
BOC - Isla Colon
CTD - Chitre
CHX - Changuinola
DAV - David
ONX - Colon
BLB - Panama City
JQE - Jaque
PLP - La Palma
PAC - Albrook
PUE - Puerto Obaldia
BLB - Panama City
RIH - Rio Hato
SYP - Santiago
PTY - Tocumen
PVE - El Porvenir
NBL - Wannukandi
FON - La Fortuna/San Carlos
TTQ - Roxana
BAI - Punta Arenas
BCL - Pococi
CSC - Guapiles
OTR - Corredores
JAP - Puntarenas
RIK - Nicoya
DRK - Puntarenas
FMG - Brasilito
GLF - Golfito
GPL - Pococi
PBP - Nandayure
LIR - Liberia
LSL - Los Chiles
LIO - Puerto Limon
CSC - Canas
NCT - Nicoya/Guanacate
NOB - Nicoya
SJO - San Jose
PJM - Puerto Jimenez
PMZ - Palmar Sur
SYQ - San Jose
XQP - Quepos
RFR - Rio Frio / Progreso
IPZ - Perez Zeledon
PLD - Playa Samara
TOO - Coto Brus
TNO - Santa Cruz
TMU - Nicoya
UPL - Upala
SAL - Santa Clara
ILS - San Salvador
CYA - Les Cayes
CAP - Cap Haitien
JAK - Jacmel
JEE - Jeremie
PAP - Port-au-Prince
PAX - Port-de-Paix
BCA - Baracoa
BWW - Cayo Santa Maria
BYM - Bayamo
AVI - Ciego de Avila
CCC - Cayo Coco
CFG - Cienfuegos
CYO - Cayo Largo del Sur
CMW - Camaguey
QCO - Colon
SCU - Santiago
NBW - Guantanamo Bay Naval Station
GAO - Guantanamo
HAV - Havana
HOG - Holguin
VRO - Matanzas
LCL - Pinar del Rio
UMA - Maisi
MJG - Mayajigua
MOA - Moa
MZO - Manzanillo
QSN - San Nicolas
ICR - Nicaro
GER - Nueva Gerona
UPB - Havana
QPD - Pinar del Rio
SNU - Santa Clara
SNJ - Pinar Del Rio
SZJ - Isla de la Juventud
USS - Sancti Spiritus
TND - Trinidad
VRA - Varadero
VTU - Las Tunas
CYB - Cayman Brac
LYB - Little Cayman
GCM - Georgetown
MAY - Mangrove Cay
COX - Andros
MHH - Marsh Harbour
SAQ - Andros Island
AXP - Spring Point
TCB - Treasure Cay
BIM - South Bimini
ATC - Arthur's Town
CAT - Cat Island
CXY - Cat Cay
CRI - Colonel Hill
PWN - Pitts Town
GGT - George Town
ELH - North Eleuthera
GHB - Governor's Harbour
RSD - Rock Sound
FPO - Freeport
GBI - Grand Bahama
WTD - West End
IGA - Matthew Town
LGI - Deadman's Cay
SML - Stella Maris
MYG - Mayaguana
NAS - Nassau
PID - Nassau
ZSA - San Salvador
BZE - Belize City
AIT - Aitutaki
AIU - Atiu Island
MGS - Mangaia Island
MHX - Manihiki Island
MUK - Mauke Island
MOI - Mitiaro Island
PYE - Penrhyn Island
RAR - Avarua
ICI - Cicia
NAN - Nadi
PTF - Malolo Lailai Island
KDV - Vunisea
MNF - Mana Island
MFJ - Moala
SUV - Nausori
LEV - Bureta
NGI - Ngau
LUC - Laucala Island
LKB - Lakeba Island
TVU - Matei
KXF - Koro Island
RTA - Rotuma
SVU - Savusavu
VAU - Vatukoula
KAY - Wakaya Island
ONU - Ono-I-Lau
YAS - Yasawa Island
EUA - Eua Island
TBU - Nuku'alofa
HPA - Lifuka
Niu - Angaha
NTT - Niuatoputapu
VAV - Vava'u Island
VBV - Vanua Balavu
VTF - Vatulele
ABF - Abaiang
BEZ - Beru
FUN - Funafuti
KUC - Kuria
MNK - Maiana
MZK - Marakei
MTK - Makin Island
NIG - Nikunau
OOT - Onotoa
TRW - Tarawa
AEA - Abemama Atoll
TMN - Tamana Island
NON - Nonouti
AIS - Arorae Island
TSU - Tabiteuea South
BBG - Butaritari Atoll
AAK - Buariki
IUE - Alofi
FUT - Futuna Island
WLS - Wallis Island
OFU - Ofu Village
AAU - Asau
APW - Apia
FGI - Apia
FTI - Fitiuta Village
MXS - Maota
PPG - Pago Pago
PPT - Papeete
APK - Apataki
HHZ - Hikueru Atoll
NAU - Napuka Island
TKV - Tatakoto
PUK - Pukarua
NUK - Nukutavake
AHE - Ahe Atoll
KHZ - Kauehi
FHZ - Fakahina
TJN - Takume
KXU - Katiu
UAP - Ua Pou
UAH - Ua Huka
BOB - Motu Mute
TTI - Tetiaroa
HUH - Fare
RFP - Uturoa
UOA - Mururoa Atoll
VHZ - Vahitahi
MTV - Ablow
SLH - Sola
TOH - Loh/Linua
EAE - Sangafa
CCV - Craig Cove
LOD - Longana
SSR - Pentecost Island
PBJ - Paama Island
LPM - Lamap
LNB - Lamen Bay
MWF - Maewo Island
LNE - Lonorore
NUS - Norsup
ZGU - Gaua Island
RCL - Redcliffe
SON - Luganville
TGH - Tongoa Island
ULB - Ambryn Island
VLS - Valesdir
WLH - Walaha
SWJ - Malekula Island
OLJ - Olpoi
AUY - Anelghowhat
AWD - Aniwa
DLY - Dillon's Bay
FTA - Futuna Island
IPA - Ipota
UIQ - Quion Hill
VLI - Port Vila
TGJ - Tiga
BMY - Waala
KNQ - Kone
ILP - Ile des Pins
HLU - Houailou
KOC - Koumac
LIF - Lifou
GEA - Noumea
IOU - Ile Ouen
PUV - Poum
PDC - Mueo
MEE - Mare
TOU - Touho
UVE - Ouvea
NOU - Noumea
AKL - Auckland
TUO - Taupo
AMZ - Manurewa
CHC - Christchurch
CHT - Waitangi
DUD - Dunedin
GBZ - Claris
GIS - Gisborne
GTN - Glentanner Station
HLZ - Hamilton
KKE - Kerikeri
KAT - Kaitaia
ALR - Alexandra
MRO - Masterton
NPL - New Plymouth
NSN - Nelson
IVC - Invercargill
PCN - Picton
ZQN - Queenstown
SZS - Oban
ROT - Rotorua
TRG - Tauranga
TKZ - Tokoroa
THH - Taharoa
TWZ - Twitzel
BHE - Blenheim
WLG - Wellington
WIR - Wairoa
WAG - Wanganui
BIN - Bamiyan
BST - Bost
CCN - Chakcharan
DAZ - Darwaz
FAH - Farah
FBD - Faizabad
KWH - Khwahan
OAI - Bagram
KBL - Kabul
KHT - Khost
LQN - Qala-I-Naw
OAS - Sharana
SGA - Sheghnan
TII - Tarin Kowt
TQN - Taloqan
ZAJ - Zaranj
BAH - Manama
AHB - Abha
ULH - Al-'Ula
DMM - Ad Dammam
DWD - Dawadmi
GIZ - Jizan
QJB - Jubail
JED - Jeddah
HBT - King Khaled Military City
MED - Medina
AQI - Qaisumah
RAH - Rafha
RUH - Riyadh
RAE - Arar
XXN - Riyadh
AJF - Al-Jawf
EJH - Al Wajh
ZUL - Zilfi
ABD - Abadan
OMI - Omidiyeh
AWZ - Ahwaz
BUZ - Bushehr
AOY - Asaloyeh
KNR - Kangan
KIH - Kish Island
BDH - Bandar Lengeh
YEH - Asalouyeh
KSH - Kermanshah
IIL - Ilam
IFH - Hesa
IFN - Isfahan
CQD - Shahrekord
RAS - Rasht
HDM - Hamadan
AJK - Araak
NUJ - Hamadan
IKA - Tehran
THR - Tehran
GZW - Qazvin
SNX - Semnan
BND - Bandar Abbas
KER - Kerman
HDR - Havadarya
XBJ - Birjand
CKT - Sarakhs
MHD - Mashhad
BJB - Bojnord
AFZ - Sabzevar
TCX - Tabas
BBL - Babolsar
GBT - Gorgan
BSM - Amol
SRY - Sari
FAZ - Fasa
LRR - Lar
LFM - Lamerd
SYZ - Shiraz
KHY - Khoy
ADU - Ardabil
ACP - Maragheh
PFQ - Parsabad
OMH - Urmia
TBZ - Tabriz
IMQ - Makou
AZD - Yazd
ZBR - Chabahar
ZAH - Zahedan
AMM - Amman
ADJ - Amman
AQJ - Aqaba
OMF - Mafraq
DWN - Oklahoma City
XIJ - Ahmed Al Jaber AB
KWI - Kuwait City
BEY - Beirut
KYE - Tripoli
AUH - Abu Dhabi
AAN - Al Ain
DXB - Dubai
NHD - Dubai
DWC - Jebel Ali
RKT - Ras Al Khaimah
SHJ - Sharjah
RMB - Buraimi
DQM - Duqm
FAU - Fahud
RNM - Ghaba
KHS - Khasab
MSH - Masirah
MCT - Muscat
OMM - Marmul
MNH - Al Muladdah
SLL - Salalah
OHS - Sohar
SUH - Sur
TTH - Thumrait
AAW - Abbottabad
BHW - Bhagatanwala
BNP - Bannu
WGB - Bahawalnagar
BHV - Bahawalpur
CJL - Chitral
CHB - Chilas
DBA - Dalbandin
DDU - Dadu
DEA - Dera Ghazi Khan
DSK - Dera Ismael Khan
LYP - Faisalabad
GWD - Gwadar
GIL - Gilgit
ISB - Islamabad
JAG - Jacobabad
JIW - Jiwani
KHI - Karachi
HDD - Hyderabad
KDD - Khuzdar
KBH - Kalat
OHT - Kohat
LHE - Lahore
LRG - Loralai
XJM - Mangla
MFG - Muzaffarabad
MWD - Mianwali
MJD - Moenjodaro
MPD - Sindhri
MUX - Multan
WNS - Nawabash
NHS - Nushki
ORW - Ormara Raik
PAJ - Parachinar
PJG - Panjgur
PSI - Pasni
PEW - Peshawar
UET - Quetta
RYK - Rahim Yar Khan
ISB - Islamabad
RAZ - Rawalakot
SBQ - Sibi
KDU - Skardu
SKZ - Mirpur Khas
SYW - Sehwan Sharif
SGI - Sargodha
SDT - Saidu Sharif
SKT - Sialkot
SUL - Sui
SWN - Sahiwal
TLB - Tarbela
BDN - Badin
TFT - Taftan
TUK - Turbat
WAF - Waana
PZH - Fort Sandeman
IQA - Hit
TQD - Al Habbaniyah
BMN - Bamarni
BGW - Baghdad
OSB - Mosul
EBL - Arbil
KIK - Kirkuk
BSR - Basrah
NJF - Najaf
RQW - Qayyarah
ISU - Sulaymaniyah
ALP - Aleppo
DAM - Damascus
DEZ - Deir ez-Zor
KAC - Kamishly
LTK - Latakia
DIA - Doha
IUD - Ar Rayyan
DOH - Doha
ADE - Aden
BYD - Al-Bayda
HOD - Hodeida
MYN - Mareb
IHN - Qishn
RIY - Riyan
SYE - Sadah
SAH - Sana'a
SCT - Socotra Islands
GXF - Sayun
TAI - Ta'izz
AKB - Atka
PML - Cold Bay
PAQ - Palmer
BTI - Barter Island Lrrs
BET - Bethel
BVU - Beluga
BIG - Delta Junction Ft Greely
BKC - Buckland
BMX - Big Mountain
BRW - Barrow
BTT - Bettles
CDB - Cold Bay
CEM - Central
CHU - Chuathbaluk
CIK - Chalkyitsik
CYF - Chefornak
SCM - Scammon Bay
IRC - Circle
WSF - Cape Sarichef
CDV - Cordova
CXF - Coldfoot
CYT - Yakataga
CZF - Cape Romanzof
DRG - Deering
RDB - Red Dog
ADK - Adak Island
DLG - Dillingham
MLL - Marshall
ADQ - Kodiak
DUT - Unalaska
KKH - Kongiganak
EDF - Anchorage
EEK - Eek
EAA - Eagle
EHM - Cape Newenham
EIL - Fairbanks
EMK - Emmonak
ENA - Kenai
WWT - Newtok
FAI - Fairbanks
FBK - Fairbanks/Ft Wainwright
AFE - Kake
ABL - Ambler
NIB - Nikolai
FMC - Five Mile
FWL - Farewell
GAL - Galena
GBH - Galbraith Lake
KWK - Kwigillingok
GKN - Gulkana
GLV - Golovin
GAM - Gambell
BGQ - Big Lake
GST - Gustavus
NME - Nightmute
SGY - Skagway
GMT - Granite Mountain
HCR - Holy Cross
HNE - Tahneta Pass Lodge
HSL - Huslia
HNS - Haines
HOM - Homer
HPB - Hooper Bay
HUS - Hughes
SHX - Shageluk
IGG - Igiugig
EGX - Egegik
IAN - Kiana
ILI - Iliamna
UTO - Utopia Creek
MCL - Mckinley Park
WAA - Wales
JNU - Juneau
KGK - Koliganek
KDK - Kodiak
KFP - False Pass
AKK - Akhiok
KPN - Kipnuk
KKA - Koyuk
LKK - Kulik Lake
AKN - King Salmon
IKO - Nikolski
AKP - Anaktuvuk Pass
KTN - Ketchikan
UUK - Kuparuk
KAL - Kaltag
AKW - Klawock
KYK - Karluk
KLN - Larsen Bay
KLG - Kalskag
PTA - Port Alsworth
LNI - Lonely
DQH - Deadhorse
WCR - Chandalar Lake
LUR - Cape Lisburne
KMO - Manokotak
MCG - McGrath
MDO - Middleton Island
LMA - Minchumina
SMK - St Michael
MLY - Manley Hot Springs
MOU - Mountain Village
MRI - Anchorage
MXY - Mccarthy
MYU - Mekoryuk
WNA - Napakiak
ANC - Anchorage
ANI - Aniak
ENN - Nenana
NNL - Nondalton
ANN - Annette
NUL - Nulato
ANV - Anvik
KNW - New Stuyahok
OBU - Kobuk
PCA - Portage Creek
HNH - Hoonah
OME - Nome
OOK - Toksook Bay
ORT - Northway
OTZ - Kotzebue
NLG - Nelson Lagoon
PBV - St George
KPC - Port Clarence
KPV - Perryville
PSG - Petersburg
PTH - Port Heiden
PKA - Napaskiak
PTU - Platinum
PIP - Pilot Point
PHO - Point Hope
PPC - Prospect Creek
KWN - Quinhagak
NUI - Nuiqsut
ARC - Arctic Village
RSH - Russian Mission
RBY - Ruby
SVA - Savoonga
SCC - Deadhorse
SDP - Sand Point
SHH - Shishmaref
SIT - Sitka
WLK - Selawik
SQL - Sleetmute
KSM - St Mary's
SNP - St Paul Island
SOV - Seldovia
SMU - Sheep Mountain
UMM - Summit
SVW - Sparrevohn
SKW - Skwentna
SXQ - Soldotna
SYA - Shemya
TAL - Tanana
TNC - Tin City
TLA - Teller
TOG - Togiak Village
TKJ - Tok
TKA - Talkeetna
TLJ - Takotna
ATK - Atqasuk
AUK - Alakanuk
UMT - Umiat
UNK - Unalakleet
WOW - Willow
VAK - Chevak
KVC - King Cove
VDZ - Valdez
VEE - Venetie
KVL - Kivalina
WBQ - Beaver
SWD - Seward
WRG - Wrangell
AIN - Wainwright
WMO - White Mountain
WTK - Noatak
IYS - Wasilla
YAK - Yakutat
CIS - Abariringa
AKI - Akiak
AET - Allakaket
NCN - Chenega
CLP - Clarks Point
ELI - Elim
KUK - Kasigluk
KNK - Kokhanok
KOT - Kotlik
KTS - Brevig Mission
KYU - Koyukuk
KWT - Kwethluk
ORV - Noorvik
SKK - Shaktoolik
TKJ - Tok
WSN - South Naknek
FYU - Fort Yukon
ROP - Rota Island
SPN - Saipan Island
UAM - Andersen
GUM - Hagatna
TIQ - Tinian Island
BKH - Kekaha
HDH - Mokuleia
HHI - Wahiawa
HNM - Hana
JHM - Lahaina
JRF - Kapolei
KOA - Kailua/Kona
LIH - Lihue
LUP - Kalaupapa
MKK - Kaunakakai
MUE - Kamuela
NGF - Kaneohe
HNL - Honolulu
LNY - Lanai City
OGG - Kahului
PAK - Hanapepe
BSF - Camp Pohakuloa
ITO - Hilo
UPP - Hawi
ENT - Eniwetok Atoll
MAJ - Majuro Atoll
KIA - Kaieteur Falls
KWA - Kwajalein
CXI - Banana
TNV - Tabuaeran Island
MDY - Sand Island
PIZ - Point Lay
TKK - Weno Island
PNI - Pohnpei Island
ROR - Babelthuap Island
KSA - Okat
YAP - Yap Island
AWK - Wake Island
KNH - Shang-I
PIF - Pingtung
LZN - Nangang Island
TTT - Taitung City
GNI - Lyudao
KHH - Kaohsiung City
CYI - Chiayi City
HCN - Hengchung
TXG - Taichung City
KYD - Orchid Island
RMQ - Taichung City
MFK - Beigan Island
TNN - Tainan City
HSZ - Hsinchu City
MZG - Makung City
PIF - Pingtung
TSA - Taipei City
TPE - Taipei
WOT - Wang-an
HUN - Hualien City
NRT - Tokyo
MMJ - Matsumoto
IBR - Omitama
KIX - Osaka
SHM - Shirahama
UKB - Kobe
TJH - Tajima
OBO - Obihiro
CTS - Chitose / Tomakomai
HKD - Hakodate
KUH - Kushiro
MMB - Ozora
SHB - Nakashibetsu
OKD - Sapporo
WKJ - Wakkanai
IKI - Iki
UBJ - Ube
TSJ - Tsushima
MBE - Monbetsu
AKJ - Asahikawa
RIS - Rishiri
FUJ - Goto
FUK - Fukuoka
KOJ - Kagoshima
KMI - Miyazaki
OIT - Oita
KKJ - Kitakyushu
HSG - Saga
KMJ - Kumamoto
NGS - Nagasaki
NGO - Tokoname
ASJ - Amami
TKN - Tokunoshima
NKM - Nagoya
QGU - Gifu
KMQ - Kanazawa
OKI - Okinoshima
TOY - Toyama
NTQ - Wajima
HIJ - Hiroshima
OKJ - Okayama City
IZO - Izumo
YGJ - Yonago
IWK - Iwakuni
KCZ - Nankoku
MYJ - Matsuyama
ITM - Osaka
TTJ - Tottori
TKS - Tokushima
TAK - Takamatsu
IWJ - Masuda
AOJ - Aomori
GAJ - Yamagata
FKS - Sukagawa
AXT - Akita
MSJ - Misawa
KIJ - Niigata
ONJ - Odate
SDJ - Sendai
SYO - Shonai
HAC - Hachijojima
OIM - Izu Oshima
MYE - Miyakejima
HND - Tokyo
OKO - Fussa
KWJ - Gwangju
KUV - Kunsan
CHN - Jeon Ju
RSU - Yeosu
QUN - Chun Chon City
WJU - Wonju
YNY - Sokcho / Gangneung
CJU - Jeju City
CHF - Jinhae
PUS - Busan
HIN - Sacheon
USN - Ulsan
ICN - Seoul
GMP - Seoul
KPO - Pohang
TAE - Daegu
HMY - Seosan
CJJ - Cheongju
OKA - Naha
ISG - Ishigaki
KJP - Kerama
MMY - Miyako City
AGJ - Aguni
HTR - Hateruma
SFS - Olongapo City
CRK - Angeles City
LAO - Laoag City
MNL - Manila
CYU - Cuyo
LGP - Legazpi City
NSP - Cavite City
AAV - Surallah
GES - General Santos City
CBO - Cotabato City
DVO - Davao City
BXU - Butuan City
DPL - Dipolog City
CGY - Cagayan De Oro City
MLP - Malabang
OZC - Ozamiz City
PAG - Pagadian City
SUG - Surigao City
CDY - Mapun
IPE - Ipil
CGY - Malaybalay City
ZAM - Zamboanga City
IAO - Del Carmen
RZP - Taytay Airport
BAG - Baguio City
DTE - Daet
SJI - San Jose
WNP - Naga
BSO - Basco
BQA - Baler
TUG - Tuguegarao City
VRC - Virac
MRQ - Gasan
CYZ - Cauayan City
TAC - Tacloban City
BCD - Bacolod City
CYP - Calbayog City
DGT - Dumaguete City
MPH - Malay
CRM - Catarman
ILO - Iloilo City
MBT - Masbate
KLO - Kalibo
CEB - Lapu-Lapu City
OMC - Ormoc City
PPS - Puerto Princesa City
RXS - Roxas City
EUQ - San Jose
TAG - Tagbilaran City
TBH - Romblon
USU - Coron
BPR - Borongan City
ENI - El Nido
CCT - Colonia Catriel
COC - Concordia
GHU - Gualeguaychu
JNI - Junin
PRA - Parana
ROS - Rosario
SFN - Santa Fe
AEP - Buenos Aires
LCM - La Cumbre
COR - Cordoba
FDO - San Fernando
LPG - La Plata
EPA - El Palomar
MJR - Miramar
EZE - Ezeiza
RAF - Rafaela
NCJ - Sunchales
HOS - Chos Malal
CVH - Lafontaine
GNR - General Roca
RDS - Rincon de los Sauces
APZ - Zapala
MDZ - Mendoza
LGS - Malargue
AFA - San Rafael
CTC - Catamarca
SDE - Santiago del Estero
RHD - Rio Hondo
IRJ - La Rioja
TUC - San Miguel de Tucuman
UAQ - San Juan
CRR - Ceres
RCU - Rio Cuarto
VDR - Villa Dolores
VME - Villa Reynolds
RLO - Merlo
LUQ - San Luis
CNQ - Corrientes
RES - Resistencia
FMA - Formosa
IGR - Puerto Iguazu
AOL - Paso de los Libres
MCS - Monte Caseros
PSS - Posadas
PRQ - Presidencia Roque Saenz Pena
SLA - Salta
JUJ - San Salvador de Jujuy
ORA - Oran
TTG - Tartagal
CLX - Clorinda
ELO - El Dorado
OYA - Goya
LLS - Las Lomitas
MDX - Mercedes
RCQ - Reconquista
UZU - Curuzu Cuatia
EHL - El Bolson
CRD - Comodoro Rivadavia
EMX - El Maiten
EQS - Esquel
LHS - Las Heras
IGB - Ingeniero Jacobacci
OLN - Sarmiento
OES - San Antonio Oeste
MQD - Maquinchao
ARR - Alto Rio Senguerr
SGV - Sierra Grande
REL - Rawson
VDM - Viedma / Carmen de Patagones
PMY - Puerto Madryn
ING - El Calafate
FTE - El Calafate
PUD - Puerto Deseado
RGA - Rio Grande
RGL - Rio Gallegos
USH - Ushuahia
ULA - San Julian
ROY - Rio Mayo
PMQ - Perito Moreno
GGS - Gobernador Gregores
JSM - Chubut
RYO - El Turbio
RZA - Santa Cruz
BHI - Bahia Blanca
CSZ - Coronel Suarez
OVR - Olavarria
GPO - General Pico
OYO - Tres Arroyos
SST - Santa Teresita
MDQ - Mar del Plata
NQN - Neuquen
NEC - Necochea
PEH - Pehuajo
RSA - Santa Rosa
BRC - San Carlos de Bariloche
TDL - Tandil
VLG - Villa Gesell
CUT - Cutral-Co
CPC - Chapelco/San Martin de los Andes
CDJ - Conceicao Do Araguaia
JTC - Bauru
0 - Rio De Janeiro
0 - Amapa
AQA - Araraquara
AJU - Aracaju
AIF - Assis
AFL - Alta Floresta
ARU - Aracatuba
AAX - Araxa
BEL - Belem
BGX - Bage
PLU - Belo Horizonte
BFH - Curitiba
BJP - Braganca Paulista
QAK - Barbacena
BSB - Brasilia
BAT - Barretos
BAU - Bauru
BVB - Boa Vista
BPG - Barra Do Garcas
BZC - Cabo Frio
CAC - Cascavel
CFB - Cabo Frio
0 - Cacador
CNF - Belo Horizonte
CGR - Campo Grande
XAP - Chapeco
CLN - Carolina
CKS - Carajas
CCM - Criciuma
CLV - Caldas Novas
QNS - Porto Alegre
CAW - Campos Dos Goytacazes
CMG - Corumba
CWB - Curitiba
CRQ - Caravelas
CXJ - Caxias Do Sul
CGB - Cuiaba
CZS - Cruzeiro Do Sul
BYO - Bonito
PPB - Presidente Prudente
MAO - Manaus
JCR - Jacareacanga
ESI - Espinosa
0 - Sao Pedro Da Aldeia
IGU - Foz Do Iguacu
FLN - Florianopolis
FEN - Fernando De Noronha
0 - Sao Jose Da Barra
FOR - Fortaleza
GIG - Rio De Janeiro
GJM - Guajara-Mirim
GYN - Goiania
0 - Gaviao Peixoto
GRU - Sao Paulo
GPB - Guarapuava
GVR - Governador Valadares
GUJ - Guaratingueta
ATM - Altamira
ITA - Itacoatiara
ITB - Itaituba
IOS - Ilheus
IPN - Ipatinga
0 - Itumbiara
IMP - Imperatriz
0 - Belem
JJD - Jijoca de Jericoacoara
JDF - Juiz De Fora
JPA - Joao Pessoa
JDO - Juazeiro Do Norte
JOI - Joinville
CPV - Campina Grande
VCP - Campinas
LEC - Lencois
LAJ - Lages
LIP - Lins
LDB - Londrina
LAZ - Bom Jesus Da Lapa
0 - Lagoa Santa
MAB - Maraba
MQH - Minacu
MEU - Almeirim
MEA - Macae
MGF - Maringa
MOC - Montes Claros
MII - Marilia
PLL - Manaus
MCZ - Maceio
MCP - Macapa
MVF - Mossoro
SAO - Sao Paulo
MNX - Manicore
NVT - Navegantes
GEL - Santo Angelo
NAT - Natal
OYK - Oiapoque
POA - Porto Alegre
PHB - Parnaiba
POO - Pocos De Caldas
PFB - Passo Fundo
PMW - Palmas
PET - Pelotas
PNZ - Petrolina
PNB - Porto Nacional
PMG - Ponta Pora
0 - Belo Horizonte
BPS - Porto Seguro
PVH - Porto Velho
VDC - Vitoria Da Conquista
RBR - Rio Branco
REC - Recife
SDU - Rio De Janeiro
RAO - Ribeirao Preto
SNZ - Rio De Janeiro
SJK - Sao Jose Dos Campos
SLZ - Sao Luis
RIA - Santa Maria
STM - Santarem
CGH - Sao Paulo
SJP - Sao Jose Do Rio Preto
SSZ - Guaruja
SSA - Salvador
QHP - Taubate
TMT - Oriximina
UNA - Una
TOW - Toledo
THE - Teresina
TFF - Tefe
TJL - Tres Lagoas
TRQ - Tarauaca
TEC - Telemaco Borba
0 - Torres
TBT - Tabatinga
TUR - Tucurui
SJL - Sao Gabriel Da Cachoeira
PAV - Paulo Afonso
URG - Uruguaiana
UDI - Uberlandia
UBA - Uberaba
VAG - Varginha
BVH - Vilhena
VIX - Vitoria
0 - Sao Gabriel Da Cachoeira
QPS - Pirassununga
IZA - Juiz De Fora
ZUD - Ancud
LOB - Los Andes
WAP - Alto Palena
ARI - Arica
WPA - Puerto Aysen
CPO - Copiapo
BBA - Balmaceda
TOQ - Tocopilla
CCH - Chile Chico
CJC - Calama
YAI - Chillan
PUQ - Punta Arenas
COW - Coquimbo
GXQ - Coyhaique
IQQ - Iquique
SCL - Santiago
ESR - El Salvador
FRT - Frutillar
ANF - Antofagasta
FRT - Frutillar
WPR - Porvenir
FFU - Futaleufu
LSQ - Los Angeles
WPU - Puerto Williams
LGR - Cochrane
CCP - Concepcion
IPC - Isla De Pascua
ZOS - Osorno
CPP - Pica
VLR - Vallenar
ZLR - Linares
PNT - Puerto Natales
OVL - Ovalle
ZPC - Pucon
MHC - Dalcahue
PUX - Puerto Varas
CNR - Chanaral
VAP - Vina Del Mar
QRC - Rancagua
TNM - Isla Rey Jorge
SMB - Cerro Sombrero
LSC - La Serena-Coquimbo
SSD - San Felipe
WCA - Castro
ZCO - Temuco
PMC - Puerto Montt
TLX - Talca
WCH - Chaiten
ZIC - Victoria
TTC - Taltal
ZAL - Valdivia
KNA - Vina Del Mar
CPQ - Campinas
0 - Santa Ernestina
QCJ - Botucatu
0 - Bariri
OLC - Sao Paulo De Olivenca
SOD - Sorocaba
0 - Moncoes
QDC - Dracena
0 - Palmares Paulista
0 - Barretos
0 - Altair
0 - Garca
0 - Jaboticabal
JLS - Jales
0 - Sao Joaquim Da Barra
0 - Morro Agudo
QOA - Mococa
0 - Lucelia
0 - Leme
QGC - Lencois Paulista
0 - Matao
0 - Mirassol
0 - Mogi Mirim
0 - Novo Horizonte
0 - Nova Europa
QNV - Nova Iguacu
OUS - Ourinhos
OIA - Ourilandia Do Norte
0 - Presidente Venceslau
QHB - Piracicaba
0 - Sao Miguel Arcanjo
QIQ - Rio Claro
QVP - Avare
QRZ - Resende
QSC - Sao Carlos
0 - Orlandia
0 - Ubarana
UBT - Ubatuba
ITP - Itaperuna
QGS - Alagoinhas
VOT - Votuporanga
0 - Pontal
QGB - Limeira
ATF - Ambato
OCC - Coca
CUE - Cuenca
GPS - Baltra
GYE - Guayaquil
IBB - Isabela
JIP - Jipijapa
LTX - Latacunga
MRR - Macara
XMS - Macas
MCH - Machala
MEC - Manta
LGQ - Lago Agrio
PYO - Puerto Putumayo
PVO - Portoviejo
UIO - Quito
ETR - Santa Rosa
SNC - Salinas
SUQ - Sucua
PTZ - Shell Mera
SCY - San Cristobal
BHA - Bahia de Caraquez
TSC - Taisha
TPN - Tiputini
LOH - La Toma (Catamayo)
ESM - Tachina
TPC - Tarapoa
TUA - Tulcan
PSY - Stanley
ASU - Asuncion
AYO - Ayolas
BFA - Bahia Negra
CIO - Concepcion
ENO - Encarnacion
AGT - Ciudad del Este
FLM - Filadelfia
ESG - Mariscal Estigarribia
OLK - Fuerte Olimpo
PIL - Pilar
PJC - Pedro Juan Caballero
0 - Morro Agudo
0 - Guaira
LVR - Lucas do Rio Verde
FRC - Franca
0 - Ipigua
JUA - Juara
CFO - Confresa
NPR - Novo Progresso
RIG - Rio Grande
ACR - Araracuara
ACD - Acandi
HAY - Aguachica
AFI - Amalfi
ADN - Andes
API - Apiay
AXM - Armenia
PUU - Puerto Asis
ELB - El Banco
BGA - Bucaramanga
BOG - Bogota
BAQ - Barranquilla
BSC - Bahia Solano
BUN - Buenaventura
CPB - Capurgana
CUC - Cucuta
COG - Condoto
CTG - Cartagena
CCO - Puerto Lopez
CLO - Cali
CIM - Cimitarra
RAV - Cravo Norte
TCO - Tumaco
BHF - Bahia Solano
CUO - Caruru
CAQ - Caucasia
CVE - Covenas
CZU - Corozal
EBG - El Bagre
EJA - Barrancabermeja
FLA - Florencia
FDA - Fundacion
GIR - Girardot
CRC - Cartago
GPI - Guapi
GLJ - Garzon
CPL - Chaparral
HTZ - Hato Corozal
IBE - Ibague
IGO - Chigorodo
MMP - Limon
IPI - Ipiales
APO - Carepa
LQM - Puerto Leguizamo
MCJ - La Mina-Maicao
LPD - La Pedrera
LET - Leticia
EOH - Medellin
MFS - Miraflores
MGN - Magangue
MTB - Montelibano
MMP - Mompos
MTR - Monteria
MVP - Mitu
MZL - Manizales
NCI - Necocli
NQU - Nuqui
NVA - Neiva
OCV - Ocana
ORC - Orocue
OTU - El Rhin
RON - Paipa
PCR - Puerto Carreno
PDA - Puerto Inirida
PEI - Pereira
PTX - Pitalito
PLT - Plato
NAR - Armenia
PPN - Popayan
PQE - La Dorada
PBE - Puerto Berrio
PSO - Pasto
PVA - Providencia
PZA - Paz De Ariporo
MQU - Mariquita
MDE - Rionegro
RCH - Riohacha
RVE - Saravena
SJE - San Jose Del Guaviare
SMR - Santa Marta
SOX - Sogamoso
ADZ - San Andres
SVI - San Vicente Del Caguan
TAU - Tauramena
TIB - Tibu
TDA - Trinidad
TLU - Tolu
TME - Tame
TQS - Tres Esquinas
TRB - Turbo
AUC - Arauca
UIB - Quibdo
ULQ - Tulua
URR - Urrao
VGZ - Villa Garzon
PYA - Velasquez
VUP - Valledupar
VVC - Villavicencio
AYG - San Vicente Del Caguan
EYP - El Yopal
MHW - El Banado
SRE - Sucre
APB - Apolo
ASC - Ascension de Guarayos
BVL - Baures
BJO - Bermejo
CAM - Camiri
CBB - Cochabamba
CIJ - Cobija
CEP - Concepcion
SRZ - Santa Cruz
GYA - Guayaramerin
BVK - Itenes
SJS - San Jose de Chiquitos
SJB - San Joaquin
SJV - San Javier
LPB - La Paz / El Alto
MGD - Magdalena
ORU - Oruro
POI - Potosi
PUR - Puerto Rico/Manuripi
PSZ - Puerto Suarez
SRD - San Ramon / Mamore
RBO - Robore
RIB - Riberalta
RBQ - Rurenabaque
REY - Reyes
SBL - Santa Ana del Yacuma
SRJ - San Borja
SNG - San Ignacio de Velasco
SNM - San Ignacio de Moxos
SRB - Santa Rosa
SRE - Sucre
MQK - San Matias
TJA - Tarija
TDD - Trinidad
UYU - Quijarro
VAH - Vallegrande
VLM - Villamontes
VVI - Santa Cruz
BYC - Yacuiba
ABN - Albina
BTO - Botopasi
AAJ - Awaradam
TOT - Totness
DRJ - Drietabbetje
DOE - Djumu-Djomoe
LDO - Aurora
PBM - Zandery
MOJ - Moengo
ICK - Nieuw Nickerie
OEM - Paloemeu
SMZ - Stoelmanseiland
KCB - Kasikasima
AGI - Wageningen Airport
WSO - Washabo
ORG - Paramaribo
APY - Alto Parnaiba
APQ - Arapiraca
AMJ - Almenara
0 - Aracaju
BDC - Barra Do Corda
BVM - Belmonte
0 - Boquira
BRA - Barreiras
BSS - Balsas
BMS - Brumado
BQQ - Barra
0 - Campo Do Meio
CTP - Carutapera
CPU - Cururupu
0 - Campina Verde
QCH - Colatina
RDC - Redencao
LEP - Leopoldina
DTI - Diamantina
DIQ - Divinopolis
CNV - Canavieiras
0 - Recife
0 - Formiga
SXX - Sao Felix Do Xingu
GUZ - Guarapari
GDP - Guadalupe
GNM - Guanambi
0 - Grajau
GMS - Uberlandia
QGP - Garanhuns
IRE - Irece
QIG - Iguatu
QIT - Itapetinga
IPU - Ipiau
JCM - Jacobina
FEC - Feira De Santana
JEQ - Jequie
JNA - Januaria
JDR - Sao Joao Del Rei
CMP - Santana Do Araguaia
QDF - Conselheiro Lafaiete
CDI - Cachoeiro Do Itapemirim
0 - Colinas
QCP - Currais Novos
LVB - Livramento Do Brumado
SSO - Sao Lourenco
MTE - Monte Alegre
0 - Mombaca
0 - Monte Santo De Minas
MVS - Mucuri
SBJ - Sao Mateus
PTQ - Porto De Moz
NNU - Nanuque
QBX - Sobral
0 - Morro Do Chapeu
0 - Oeiras
0 - Ouro Fino
0 - Propria
PSW - Passos
FEJ - Feijo
ORX - Oriximina
0 - Pastos Bons
PCS - Picos
POJ - Patos De Minas
0 - Piata
0 - Patrocinio
0 - Pompeu
0 - Paraguacu
PIV - Pirapora
FLB - Floriano
0 - Magda
PDF - Prado
0 - Rio Paranaiba
CAU - Caruaru
0 - Riachao
0 - Sacramento
0 - Santarem
SFK - Soure
TXF - Teixeira De Freitas
OBI - Obidos
0 - Monte Carmelo
TFL - Teofilo Otoni
0 - Buritirama
VAL - Valenca
0 - Santa Maria Da Vitoria
0 - Conceicao Das Alagoas
QID - Tres Coracoes
BVS - Breves
CMC - Camocim
0 - Machado
QXC - Barra De Santo Antonio
GGF - Almeirim
PHI - Pinheiro
ITI - Cumaru Do Norte
PPY - Pouso Alegre
ITE - Itubera
CAY - Cayenne / Rochambeau
GSI - Grand-Santi
MPY - Maripasoula
OXP - Saint-Georges-de-l'Oyapock Airport
LDX - Saint-Laurent-du-Maroni
REI - Regina
XAU - Saul
APE - San Juan Aposento
ALD - Fortaleza
AOP - Andoas
ATG - Atalaya
MBP - Moyobamba
BLP - Bellavista
IBP - Iberia
PCL - Pucallpa
TDP - Corrientes
CHM - Chimbote
TGI - Tingo Maria
CIX - Chiclayo
AYP - Ayacucho
ANS - Andahuaylas
ATA - Anta
UMI - Quince Mil
UCZ - Uchiza
RIJ - Rioja
LIM - Lima
JAE - Jaen
JJI - Juanjui
JAU - Jauja
JUL - Juliaca
SJA - San Juan de Marcona
CJA - Cajamarca
RIM - Rodriguez de Mendoza
ILQ - Ilo
TBP - Tumbes
MZA - Mazamari
SMG - Santa Maria
YMS - Yurimaguas
HUU - Huanuco
SQU - Plaza Saposoa
CHH - Chachapoyas
REQ - Requena
IQT - Iquitos
AQP - Arequipa
TRU - Trujillo
SQD - San Francisco de Yeso
PIO - Pisco
TPP - Tarapoto
SYC - Shiringayoc
TCQ - Tacna
PEM - Puerto Maldonado
PIU - Piura
CUZ - Cusco
APU - Apucarana
0 - Passo Fundo
BGV - Bento Goncalves
BNU - Blumenau
0 - Bandeirantes
CCI - Concordia
CSS - Cassilandia
QCN - Canela
CKO - Cornelio Procopio
GGH - Cianorte
DOU - Dourados
0 - Sao Sepe
ERM - Erechim
FBE - Francisco Beltrao
0 - Guapore
QGA - Guaira
HRZ - Horizontina
IJU - Ijui
ITQ - Itaqui
JCB - Joacaba
0 - Julio De Castilho
CBW - Campo Mourao
QDB - Cachoeira Do Sul
QCR - Curitibanos
OAL - Cacoal
0 - Laguna
LVB - Itirapina
LOI - Lontras
ALQ - Alegrete
QMF - Mafra
QGF - Montenegro
QHV - Novo Hamburgo
0 - Nonoai
0 - Nova Prata
SQX - Sao Miguel Do Oeste
APX - Arapongas
AIR - Paracatu
PTO - Pato Branco
PNG - Paranagua
PVI - Paranavai
PBB - Paranaiba
0 - Tanque Novo
0 - Mundo Novo
QAC - Castro
SQY - Sao Lourenco Do Sul
QOJ - Sao Borja
CSU - Santa Cruz Do Sul
0 - Soledade
0 - Sao Gabriel
0 - Sao Joaquim
0 - Sertanopolis
0 - Tres Passos
UMU - Umuarama
QVB - Uniao Da Vitoria
0 - Guaira
VIA - Videira
0 - Veranopolis
CTQ - Santa Vitoria Do Palmar
0 - Pitangueiras
0 - Venancio Aires
0 - Cacapava Do Sul
0 - Sarandi
AXE - Xanxere
AAG - Arapoti
SRA - Santa Rosa
0 - Centenario Do Sul
PGZ - Ponta Grossa
ATI - Artigas
CYR - Colonia
CAR - Carmelo
DZO - Durazno
PDP - Punta del Este
MER - Mercedes
MLZ - Melo
MVD - Montevideo
MDO - Maldonado
PDU - Paysandu
RVY - Rivera
STY - Salto
TAW - Tacuarembo
TYT - Treinta y Tres
VCH - Vichadero
AGV - Acarigua
AAO - Anaco
LPJ - Guayabal
BLA - Barcelona
BNS - Barinas
BRM - Barquisimeto
MYC - Maracay
CUV - Casigua El Cubo
CLZ - Guarico
CAJ - Canaima
VCR - Carora
CUP - Carupano
CZE - Coro
isl - Isla La Tortuga
EOR - Bolivar
GUQ - Guanare
ICC - Isla de Coche
LSP - Paraguana
MAR - Maracaibo
MRD - Merida
PMV - Isla Margarita
CCS - Caracas
CBS - Cabimas
PZO - Puerto Ordaz-Ciudad Guayana
PTM - Palmarito
LRV - Los Roques
SBB - Santa Barbara
STD - Santo Domingo
SNF - San Felipe
SFD - Inglaterra
TUV - Tucupita
VLN - Valencia
VIG - El Vigia
VLV - Valera
0 - Araguaiana
0 - Buriti Alegre
BAZ - Barcelos
RBB - Borba
CAF - Carauari
CQS - Costa Marques
0 - Cavalcante
0 - Ceres
DMT - Diamantino
DNO - Dianopolis
ARS - Aragarcas
ERN - Eirunepe
CQA - Canarana
FEJ - Feijo
SXO - Sao Felix Do Araguaia
GRP - Gurupi
AUX - Araguaina
GGB - Agua Boa
HUW - Humaita
0 - Iaciara
IPG - Santo Antonio Do Ica
IDO - Cristalandia
JPR - Ji-Parana
JIA - Juina
JRN - Juruena
JTI - Jatai
CCX - Caceres
CIZ - Coari
TLZ - Catalao
0 - Caceres
LBR - Labrea
RVD - Rio Verde
MBZ - Maues
NVP - Novo Aripuana
AQM - Ariquemes
BCR - Boca Do Acre
NQL - Niquelandia
APS - Anapolis
FBA - Fonte Boa
PBV - Porto Dos Gauchos
PIN - Parintins
PBQ - Pimenta Bueno
PBX - Porto Alegre Do Norte
AAI - Arraias
ROO - Rondonopolis
AIR - Aripuana
0 - Tesouro
OPS - Sinop
STZ - Santa Terezinha
IRZ - Santa Isabel Do Rio Negro
TGQ - Tangara Da Serra
AZL - Sapezal
QHN - Taguatinga
SQM - Sao Miguel Do Araguaia
MTG - Vila Bela Da Santissima Trindade
VLP - Vila Rica
MBK - Matupa
NOK - Nova Xavantina
AHL - Aishalton
NAI - Annai
BCG - Bemichi
BMJ - Baramita
GFO - Bartica
GEO - Georgetown
OGL - Ogle
IMB - Imbaimadai
KAR - Kamarang
KRM - Karanambo
KRG - Karasabai
KTO - Kato
LUB - Lumid Pau
LTM - Lethem
USI - Mabaruma
MHA - Mahdia
MYM - Monkey Mountain
MWJ - Matthews Ridge
QSX - New Amsterdam
ORJ - Orinduik
PRR - Paruma
ANU - St. George
BBQ - Codrington
BGI - Bridgetown
DCF - Canefield
DOM - Marigot
DSD - Grande Anse
BBR - Basse Terre
SFC - St-Francois
FDF - Fort-de-France
SFG - Grand Case
SBH - Gustavia
GBJ - Grand Bourg
PTP - Pointe-a-Pitre Le Raizet
LSS - Les Saintes
GND - Saint George's
CRU - Carriacou Island
STT - Charlotte Amalie
STX - Christiansted
ARE - Arecibo
BQN - Aguadilla
CPX - Culebra Island
FAJ - Fajardo
SIG - San Juan
MAZ - Mayaguez
PSE - Ponce
NRR - Ceiba
SJU - San Juan
VQS - Vieques Island
SKB - Basseterre
NEV - Charlestown
SLU - Castries
UVF - Vieux Fort
AUA - Oranjestad
BON - Kralendijk
CUR - Willemstad
EUX - Sint Eustatius
SXM - Saint Martin
SAB - Saba
AXA - The Valley
MNI - Gerald's Park
TAB - Scarborough
POS - Port of Spain
NGD - Anegada
EIS - Road Town
VIJ - Spanish Town
BQU - Bequia
CIW - Canouan
MQS - Mustique Island
UNI - Union Island
SVD - Kingstown
BDA - Hamilton
ALA - Almaty
BXH - Balkhash
USJ - Usharal
BXJ - Aima Ata
TDK - Taldy Kurgan
NQZ - Astana
KOV - Kokshetau
PPK - Petropavlosk
DMB - Taraz
CIT - Shymkent
HSA - Turkistan
DZN - Zhezkazgan
KGF - Karaganda
BXY - Baikonur
KZO - Kzyl-Orda
URA - Uralsk
EKB - Ekibastuz
UKK - Ust Kamenogorsk
PWQ - Pavlodar
PLX - Semey
SCO - Aktau
GUW - Atyrau
AKX - Aktyubinsk
AYK - Arkalyk
KSN - Kostanay
GYD - Baku
GNJ - Ganja
LLK - Lankaran
NAJ - Nakhchivan
GBB - Gabala
ZTU - Zaqatala
YLV - Yevlakh
IKU - Tamchy
FRU - Bishkek
OSS - Osh
LWN - Gyumri
EVN - Yerevan
UKG - Ust-Kuyga
ADH - Aldan
YKS - Yakutsk
CNN - Chulman
MQJ - Honuu
KDY - Tyopliy Klyuch
GYG - Magan
OLZ - Olyokminsk
USR - Ust-Nera
UMS - Ust-Maya
VHV - Verkhnevilyuisk
NYR - Nyurba
SUY - Suntar
VYI - Vilyuisk
ULK - Lensk
ONK - Olenyok
PYJ - Yakutia
MJZ - Mirny
SYS - Saskylakh
BGN - Belaya Gora
CKH - Chokurdah
CYX - Cherskiy
IKS - Tiksi
ZKP - Zyryanka
ZIX - Zhigansk
KUT - Kutaisi
BUS - Batumi
SUI - Sukhumi
TBS - Tbilisi
BQS - Blagoveschensk
GDG - Magdagachi
TYD - Tynda
KHV - Khabarovsk
KXK - Komsomolsk-on-Amur
GVN - Sovetskaya Gavan
DYR - Anadyr
PVS - Chukotka
KPW - Keperveem
GDX - Magadan
KVM - Markovo
PWE - Pevek
SWV - Evensk
BQG - Bogorodskoye
NLI - Nikolayevsk-na-Amure Airport
OHO - Okhotsk
PKC - Petropavlovsk-Kamchatsky
BVV - Iturup Island
OHH - Okha
EKS - Shakhtersk
DEE - Kunashir Island
ZZO - Tymovskoye
UUS - Yuzhno-Sakhalinsk
TLY - Plastun
VVO - Vladivostok
HTA - Chita
BTK - Bratsk
UIK - Ust-Ilimsk
IKT - Irkutsk
ODO - Bodaybo
ERG - Erbogachen
KCK - Kirensk
UKX - Ust-Kut
UUD - Ulan Ude
UJE - Ujae Atoll
KBP - Kiev
DOK - Donetsk
KRQ - Kramatorsk
MPW - Mariupol
SEV - Sievierodonetsk
VSG - Luhansk
ERD - Berdyansk
DNK - Dnipropetrovsk
OZH - Zaporizhia
KWG - Kryvyi Rih
SIP - Simferopol
KHC - Kerch
HRK - Kharkiv
PLV - Poltava
UMY - Sumy
CKC - Cherkasy
KGO - Kirovograd
IEV - Kiev
GML - Kiev
UCK - Lutsk
HMJ - Khmelnytskyi
IFO - Ivano-Frankivsk
LWO - Lviv
CWC - Chernivtsi
RWN - Rivne
TNL - Ternopil
UDJ - Uzhhorod
KHE - Kherson
NLV - Nikolayev
ODS - Odessa
VIN - Vinnitsa
ARH - Archangelsk
VKV - Arkhangelsk
LDG - Leshukonskoye
NNM - Naryan Mar
CSH - Solovetsky Islands
AMV - Amderma
KSZ - Kotlas
LED - St. Petersburg
KVK - Apatity
MMK - Murmansk
VLU - Velikiye Luki
PKV - Pskov
PES - Petrozavodsk
CEE - Cherepovets
VUS - Velikiy Ustyug
VGD - Vologda
BQT - Brest
GME - Gomel
VTB - Vitebsk
KGD - Kaliningrad
GNA - Hrodna
MHP - Minsk
MSQ - Minsk
MVQ - Mogilev
ABA - Abakan
BAX - Barnaul
RGK - Gorno-Altaysk
KEJ - Kemerovo
EIE - Yeniseysk
TGP - Bor
KJA - Krasnoyarsk
ACS - Achinsk
KYZ - Kyzyl
OVB - Novosibirsk
OMS - Omsk
SWT - Strezhevoy
TOF - Tomsk
NOZ - Novokuznetsk
DKS - Dikson
HTG - Khatanga
IAA - Igarka
NSK - Norilsk
THX - Turukhansk
UKS - Sevastopol
SIP - Simferopol
AAQ - Anapa
EIK - Yeysk
GDZ - Gelendzhik
KRR - Krasnodar
GRV - Grozny
MCX - Makhachkala
MRV - Mineralnyye Vody
NAL - Nalchik
OGZ - Beslan
IGT - Magas
STW - Stavropol
ROV - Rostov-on-Don
RVI - Rostov-on-Don
TGK - Taganrog
AER - Sochi
ASF - Astrakhan
ESL - Elista
VOG - Volgograd
CEK - Chelyabinsk
MQF - Magnitogorsk
SBT - Sabetta
BVJ - Bovanenkovo
SLY - Salekhard
YMK - Mys Kamennyi
KKQ - Krasnoselkup
TQL - Tarko-Sale
UEN - Urengoy
HMA - Khanty-Mansiysk
KXD - Kondinskoye
NYA - Nyagan
OVS - Sovetskiy
URJ - Uray
IJK - Izhevsk
KVX - Kirov
NYM - Nadym
NUX - Novy Urengoy
NJC - Nizhnevartovsk
PEE - Perm
KGP - Kogalym
NFG - Nefteyugansk
NOJ - Noyabrsk
SGC - Surgut
SVX - Yekaterinburg
TOX - Tobolsk
TJM - Tyumen
KRO - Kurgan
ASB - Ashgabat
KRW - Krasnovodsk
MYP - Mary
TAZ - Dashoguz
CRZ - Turkmenabat
DYU - Dushanbe
TJU - Kulyab
LBD - Khudzhand
KQT - Kurgan-Tyube
AZN - Andizhan
FEG - Fergana
NMA - Namangan
NCU - Nukus
UGC - Urgench
NVI - Navoi
BHK - Bukhara
KSQ - Karshi
KSQ - Khanabad
AFS - Zarafshan
SKD - Samarkand
TMJ - Termez
TAS - Tashkent
KMW - Kostroma
BKA - Moscow
KLF - Kaluga
IWA - Ivanovo
RYB - Rybinsk
BZK - Bryansk
LNX - Smolensk
ZIA - Zhukovsky
DME - Moscow
SVO - Moscow
KLD - Tver
OSF - Moscow
CKL - Moscow
EGO - Belgorod
URS - Kursk
LPK - Lipetsk
VOZ - Voronezh
OEL - Orel
TBW - Tambov
RZN - Ryazan
VKO - Moscow
UCT - Ukhta
INA - Inta
PEX - Pechora
USK - Usinsk
VKT - Vorkuta
UTS - Ust-Tsylma
SCW - Syktyvkar
GOJ - Nizhny Novgorod
UUA - Bugulma
KZN - Kazan
NBC - Nizhnekamsk
JOK - Yoshkar-Ola
CSY - Cheboksary
ULV - Ulyanovsk
ULY - Ulyanovsk
REN - Orenburg
OSW - Orsk
PEZ - Penza
SKX - Saransk
BWO - Balakovo
GSV - Saratov
RTW - Saratov
BCX - Beloretsk
NEF - Neftekamsk
OKT - Kzyl-Yar
UFA - Ufa
KUF - Samara
DIU - Diu
AMD - Ahmedabad
IXU - Aurangabad
BOM - Mumbai
BHJ - Bhuj
BDQ - Vadodara
BHO - Bhopal
BHU - Bhavnagar
HBX - Hubli
IDR - Indore
JGA - Jamnagar
IXY - Kandla
HJR - Khajuraho
LTU - Latur
NDC - Nanded
NAG - Naqpur
ISK - Nashik
ISK - Nasik
PNQ - Pune
PBD - Porbandar
RAJ - Rajkot
RPR - Raipur
SAG - Kakadi
SSE - Solapur
UDR - Udaipur
CMB - Colombo
ACJ - Anuradhapura
BTC - Batticaloa
RML - Colombo
GOY - Amparai
MNH - Polonnaruwa Town
JAF - Jaffna
KCT - Galle
KTY - Kalutara
GIU - Sigiriya
TRR - Trincomalee
WRZ - Weerawila
HRI - Mattala
BBM - Battambang
KKZ - Kaoh Kong
KTI - Kratie
MWV - Sen Monorom
PNH - Phnom Penh
RBE - Ratanakiri
REP - Siem Reap
TNX - Stung Treng
KOS - Sihanukville
DBR - Darbhanga
IXA - Agartala
IXB - Siliguri
RGH - Balurghat
SHL - Shillong
VNS - Varanasi
BBI - Bhubaneswar
CCU - Kolkata
DGH - Deoghar
GOP - Gorakhpur
GAU - Guwahati
IMF - Imphal
JRG - Jharsuguda
PYB - Jeypore
JRH - Jorhat
IXS - Silchar
IXN - Khowai
AJL - Aizawl
IXI - Lilabari
LDA - Malda
DIB - Dibrugarh
DMU - Dimapur
IXT - Pasighat
PAT - Patna
IXR - Ranchi
TEI - Tezu
VTZ - Visakhapatnam
BZL - Barisal
CXB - Cox's Bazar
CLA - Comilla
CGP - Chittagong
DAC - Dhaka
IRD - Ishurdi
JSR - Jashahor
LLJ - Lalmonirhat
RJH - Rajshahi
SPD - Saidpur
TKR - Thakurgaon
ZHM - Shamshernagar
ZYL - Sylhet
HKG - Hong Kong
IXD - Allahabad
ATQ - Amritsar
BKB - Bikaner
VNS - Varanasi
IXC - Chandigarh
DED - Dehradun
DEL - New Delhi
GWL - Gwalior
JDH - Jodhpur
JAI - Jaipur
IXJ - Jammu
KQH - Kishangarh
IXL - Leh
LKO - Lucknow
PGH - Pantnagar
SXR - Srinagar
AOU - Attopeu
LPQ - Luang Phabang
LXG - Luang Namtha
ODY - Oudomsay
PKZ - Pakse
ZBY - Sayaboury
VNA - Saravane
THK - Thakhek
VTE - Vientiane
XKH - Xieng Khouang
MFM - Taipa
BJH - Bajhang
BHP - Bhojpur
BGL - Baglung
BHR - Bharatpur
BJU - Bajura
BIT - Baitadi
BWA - Bhairawa
BDP - Bhadrapur
DNP - Dang
DHI - Dhangarhi
DAP - Darchula
DOP - Dolpa
SIH - Silgadi Doti
GKH - Gorkha
JIR - Jiri
JUM - Jumla
JKR - Janakpur
JMO - Jomsom
KTM - Kathmandu
LDN - Lamidanda
LUA - Lukla
LTG - Langtang
NGX - Ngawal
MEY - Meghauli
XMG - Mahendranagar
KEP - Nepalgunj
PKR - Pokhara
PPL - Phaplu
RJB - Rajbiraj
RHP - Ramechhap
RUK - Rukumkot
RPA - Rolpa
RUM - Rumjatar
SIF - Simara
SKH - Surkhet
FEB - Sanfebagar
IMK - Simikot
TPJ - Taplejung
TPU - Tikapur
TMI - Tumling Tar
BIR - Biratnagar
TCR - Thoothukkudi
BEP - Bellary
BLR - Bangalore
CJB - Coimbatore
COK - Cochin
CCJ - Calicut
GOI - Dabolim
HYD - Hyderabad
BPM - Hyderabad
CNN - Mattanur
IXM - Madurai
IXE - Mangalore
MAA - Chennai
MYQ - Mysore
IXZ - Port Blair
RJA - Rajahmundry
TJV - Thanjavur
TIR - Tirupati
TRZ - Tiruchirappally
TRV - Trivandrum
WGC - Warrangal
PBH - Paro
HDK - Kulhudhuffushi
IFU - Ifuru
FVM - Fuvahmulah Island
GAN - Gan
HAQ - Haa Dhaalu Atoll
KDO - Kadhdhoo
MLE - Male
KDM - Huvadhu Atoll
VAM - Maamigili
DMK - Bangkok
KDT - Nakhon Pathom
BKK - Bangkok
UTP - Rayong
CNX - Chiang Mai
PYY - Mae Hong Son
CEI - Chiang Rai
BAO - Ban Mak Khaen
HHQ - Hua Hin
UTR - Uttaradit
URT - Surat Thani
NST - Nakhon Si Thammarat
KBV - Krabi
USM - Na Thon (Ko Samui Island)
HKT - Phuket
HDY - Hat Yai
UTH - Udon Thani
KKC - Khon Kaen
UBP - Ubon Ratchathani
BMV - Buon Ma Thuot
VCL - Dung Quat Bay
HPH - Haiphong
CAH - Ca Mau City
CXR - Nha Trang
VCS - Con Ong
VCA - Can Tho
DIN - Dien Bien Phu
VDH - Dong Hoi
DLI - Dalat
DAD - Da Nang
HAN - Hanoi
SQH - Son-La
NHA - Nha Trang
HUI - Hue
UIH - Quy Nohn
PXU - Pleiku
PQC - Duong Dong
PHA - Phan Rang
PHH - Phan Thiet
VKG - Rach Gia
TBB - Tuy Hoa
SGN - Ho Chi Minh City
THD - Thanh H�a
VII - Vinh
VTG - Vung Tau
VBA - Aeng
NYU - Nyaung U
BMO - Banmaw
VBP - Bokpyinn
VBC - Mandalay
TVY - Dawei
NYT - Pyinmana
GAW - Gangaw
GWA - Gwa
HEH - Heho
HOX - Hommalinn
TIO - Tilin
KET - Kengtung
KHM - Kanti
KMV - Kalemyo
KYP - Kyaukpyu
KAW - Kawthoung
KYT - Kyauktu
LIW - Loikaw
LSH - Lashio
MDL - Mandalay
MGZ - Mkeik
MYT - Myitkyina
MNU - Mawlamyine
MGU - Manaung
MOG - Mong Hsat
MGK - Mong Tong
MWQ - Magway
NYW - Monywar
NMS - Namsang
NMT - Namtu
PAA - Hpa-N
PAU - Pauk
BSX - Pathein
PPU - Pa Pun
PBU - Putao
PKK - Pakhokku
PRU - Pye
AKY - Sittwe
SNW - Thandwe
THL - Tachileik
XYE - Ye
RGN - Yangon
TQQ - Waha-Tomea Island
UPG - Ujung Pandang-Celebes Island
BIK - Biak-Supiori Island
ONI - Moanamani-Papua Island
FOO - Kornasoren-Numfoor Island
WET - Wagethe-Papua Island
NBX - Nabire-Papua Island
ILA - Illaga-Papua Island
KOX - Kokonau-Papua Island
ZRI - Serui-Japen Island
TIM - Timika-Papua Island
EWI - Enarotali-Papua Island
AMI - Mataram-Lombok Island
BMU - Bima-Sumbawa Island
DPS - Denpasar-Bali Island
LOP - Mataram
SWQ - Sumbawa Island
TMC - Waikabubak-Sumba Island
WGP - Waingapu-Sumba Island
YIA - Yogyakarta
ARJ - Arso-Papua Island
BUI - Bokondini-Papua Island
ZRM - Sarmi-Papua Island
DJJ - Jayapura-Papua Island
LHI - Lereh-Papua Island
LII - Mulia-Papua Island
OKL - Oksibil-Papua Island
WAR - Waris-Papua Island
SEH - Senggeh-Papua Island
UBR - Ubrub-Papua Island
WMX - Wamena-Papua Island
MDP - Mindiptana-Papua Island
BXD - Bade-Papua Island
MKQ - Merauke-Papua Island
OKQ - Okaba-Papua Island
KEI - Kepi-Papua Island
TMH - Tanah Merah-Papua Island
TJS - Tanjung Selor-Borneo Island
DTD - Datadawai-Borneo Island
BEJ - Tanjung Redep-Borneo Island
BPN - Balikpapan-Borneo Island
TRK - Tarakan Island
AAP - Samarinda
TSX - Santan-Borneo Island
BYQ - Bunju Island
GLX - Galela-Celebes Island
GTO - Gorontalo-Celebes Island
NAH - Tahuna-Sangihe Island
TLI - Toli Toli-Celebes Island
GEB - Gebe Island
KAZ - Kao-Celebes Island
PLW - Palu-Celebes Island
MDC - Manado-Celebes Island
MNA - Karakelong Island
PSJ - Poso-Celebes Island
OTI - Gotalalamo-Morotai Island
TTE - Sango-Ternate Island
LUW - Luwok-Celebes Island
UOL - Buol-Celebes Island
BTW - Batu Licin-Borneo Island
PKN - Pangkalanbun-Borneo Island
KBU - Laut Island
MTW - Murateweh-Borneo Island
TJG - Tanta-Tabalong-Borneo Island
BDJ - Banjarmasin-Borneo Island
PKY - Palangkaraya-Kalimantan Tengah
SMQ - Sampit-Borneo Island
AHI - Amahai-Seram Island
NDA - Banda Island
DOB - Dobo-Kobror Island
MAL - Mangole Island
NRE - Namrole-Buru Island
LAH - Labuha-Halmahera Island
SXK - Saumlaki-Yamdena Island
BJK - Maikoor Island
LUV - Langgur-Seram Island
SQN - Sanana-Seram Island
AMQ - Ambon
NAM - Namlea-Buru Island
TAX - Tikong-Taliabu Island
WBA - Seram Island
MLG - Malang-Java Island
CPF - Tjepu-Java Island
JOG - Yogyakarta-Java Island
SOC - Sukarata(Solo)-Java Island
SUB - Surabaya
SRG - Semarang-Java Island
SUP - Sumenep-Madura Island
NTI - Bintuni-Papua Island
RSK - Ransiki-Papua Island
KEQ - Kebar-Papua Island
FKQ - Fakfak-Papua Island
INX - Inanwatan Airport-Papua Island
KNG - Kaimana-Papua Island
RDE - Merdei-Papua Island
BXB - Babo-Papua Island
MKW - Manokwari-Papua Island
SOQ - Sorong-Papua Island
TXM - Atinjoe-Papua Island
WSR - Wasior-Papua Island
BJW - Bajawa
MOF - Maumere-Flores Island
ENE - Ende-Flores Island
RTG - Satar Tacik-Flores Island
ARD - Alor Island
LBJ - Labuan Bajo-Flores Island
KOE - Kupang-Timor Island
BUW - Bau Bau-Butung Island
MJU - Mamuju-Celebes Island
MXB - Masamba-Celebes Island
KXB - Kolaka
SQR - Soroako-Celebes Island
TTR - Tanah Toraja-Celebes Island
KDI - Kendari-Celebes Island
BTU - Bintulu
BLG - Belaga
LSM - Long Semado
LGL - Long Datih
KCH - Kuching
ODN - Long Seridan
LMN - Limbang
MKM - Mukah
LKH - Long Akah
MUR - Marudi
BSE - Sematan
KPI - Kapit
BKM - Bakalalan
MYY - Miri
SBW - Sibu
TGC - Tanjung Manis
LSU - Long Sukang
LWY - Lawas
SGG - Simanggang
BBN - Bario
SMM - Semporna
LDU - Lahad Datu
TEL - Telupid
KGU - Keningau
SXS - Sahabat
BKI - Kota Kinabalu
LBU - Labuan
TMG - Tomanggong
GSA - Long Miau
SPE - Sepulot
PAY - Pamol
RNU - Ranau
SDK - Sandakan
KUD - Kudat
TWU - Tawau
MZV - Mulu
BWN - Bandar Seri Begawan
AKQ - Menggala-Sumatra Island
PKU - Pekanbaru-Sumatra Island
DUM - Dumai-Sumatra Island
RKO - Sipora Island
SEQ - Bengkalis-Sumatra Island
TJB - Karinmunbesar Island
BDO - Bandung-Java Island
CBN - Cirebon-Java Island
TSY - Tasikmalaya-Java Island
TKG - Bandar Lampung-Sumatra Island
BTH - Batam Island
PPR - Pasir Pengarayan-Sumatra Island
TNJ - Tanjung Pinang-Bintan Island
SIQ - Pasirkuning-Singkep Island
PDG - Ketaping/Padang-Sumatra Island
HLP - Jakarta
CXP - Cilacap-Java Island
PCB - Jakarta
PPJ - Tjipara-Java Island
CGK - Jakarta
GNS - Gunung Sitoli-Nias Island
AEG - Padang Sidempuan-Sumatra Island
MES - Medan
KNO - Medan-Sumatra Island
DTB - Siborong-Borong
SIW - Parapat-Sumatra Island
FLZ - Sibolga-Sumatra Island
TJQ - Tanjung Pandan-Belitung Island
NPO - Nanga Pinoh-Borneo Island
KTG - Ketapang-Borneo Island
MWK - Matak Island
NTX - Ranai-Natuna Besar Island
PNK - Pontianak-Borneo Island
PSU - Putussibau-Borneo Island
SQG - Sintang-Borneo Island
DJB - Jambi-Sumatra Island
PGK - Pangkal Pinang-Palaubangka Island
BKS - Bengkulu-Sumatra Island
PLM - Palembang-Sumatra Island
PDO - Talang Gudang-Sumatra Island
RGT - Rengat-Sumatra Island
PDG - Ketaping/Padang-Sumatra Island
MPC - Muko Muko-Sumatra Island
KLQ - Keluang-Sumatra Island
TPK - Tapak Tuan-Sumatra Island
MEQ - Peureumeue-Sumatra Island
LSX - Lhok Sukon-Sumatra Island
LSW - Lhok Seumawe-Sumatra Island
SBG - Sabang-We Island
BTJ - Banda Aceh-Sumatra Island
SXT - Taman Negara
MEP - Mersing
SWY - Sitiawan
TPG - Taiping
TOD - Pulau Tioman
AOR - Alor Satar
BWH - Butterworth
KBR - Kota Baharu
KUA - Kuantan
KTE - Kerteh
IPH - Ipoh
JHB - Senai
KUL - Kuala Lumpur
LGK - Langkawi
MKZ - Malacca
TGG - Kuala Terengganu
PEN - Penang
PKG - Pangkor Island
RDN - Redang
SZB - Subang
DTR - Decatur
AUT - Atauro
UAI - Suai
DIL - Dili
BCH - Baucau
MPT - Maliana
OEC - Oecussi-Ambeno
VIQ - Viqueque
ABU - Atambua-Timor Island
BJW - Bajawa-Flores Island
LKA - Larantuka-Flores Island
SAU - Sawu-Sawu Island
SGQ - Sanggata-Timor Island
LBW - Long Bawan-Borneo Island
BXT - Bontang-Borneo Island
NNX - Nunukan-Nunukan Island
TNB - Tanah Grogot-Borneo Island
LPU - Long Apung-Borneo Island
XSP - Seletar
SIN - Singapore
SKL - Broadford
ALH - Albany
ARM - Armidale
AYQ - Ayers Rock
ACF - Brisbane
BCI - Barcaldine
ASP - Alice Springs
BBE - Big Bell
BNE - Brisbane
OOL - Gold Coast
BKQ - Blackall
CNS - Cairns
CTL - Charleville
BXF - Bellburn
BHQ - Broken Hill
HTI - Hamilton Island
BZP - Lakefield National Park
BQB - Busselton
ISA - Mount Isa
MCY - Maroochydore
MKY - Mackay
BNK - Ballina
PPP - Proserpine
ROK - Rockhampton
BME - Broome
BHS - Bathurst
TSV - Townsville
BDB - Bundaberg
WEI - Weipa
WTB - Wellcamp
CBY - Canobie
CNJ - Cloncurry
CKW - Christmas Creek mine
ODL - Cordillo Downs
OOM - Cooma
DFP - Drumduff
DXD - New Dixie
DLK - Dulkaninna
DYW - Daly Waters
NLF - Darnley Island
DPO - Devonport
ETD - Etadunna
ENB - Eneabba
EIH - Einasleigh
ELC - Elcho Island
EMD - Emerald
EVD - Eva Downs
FRB - Forbes
KFE - Cloudbreak Village
FIK - Finke
GDD - Gordon Downs
GBW - Ginbata
GLT - Gladstone
GTE - Groote Eylandt
GFF - Griffith
HWK - Hawker
HVB - Hervey Bay
HID - Horn Island
MHU - Mount Hotham
IVW - Inverway
KBB - Kirkimbie
KKP - Koolburra
KWM - Kowanyama
LNO - Leonora
LDH - Lord Howe Island
LTP - Lyndhurst
LDC - Lindeman Island
LSY - Lismore
LOC - Lock
LTV - Lotus Vale
LRE - Longreach
UBB - Mabuiag Island
AVV - Melbourne
ABX - Albury
DGE - Mudgee
MQA - Mandora
MIM - Merimbula
MGT - Milingimbi Island
MNG - Maningrida
GSN - Mount Gunson
HBA - Hobart
MCV - McArthur River Mine
MQL - Mildura
MIH - Mitchell Plateau
LST - Launceston
MBW - Melbourne
MEL - Melbourne
MRZ - Moree
MET - Moreton
MQE - Marqua
MOV - Moranbah
MYA - Moruya
MUQ - Muccan Station
MNE - Mungeranie
MYI - Murray Island
MVK - Mulka
NRA - Narrandera
NAA - Narrabri
NBH - Nambucca Heads
ZNE - Newman
OLP - Olympic Dam
OAG - Orange
ODR - Ord River
ADL - Adelaide
PBO - Paraburdoo
CCK - Cocos (Keeling) Islands
DRW - Darwin
PRD - Pardoo
GOV - Nhulunbuy
JAD - Perth
KTA - Karratha
KGI - Kalgoorlie
PKE - Parkes
KNX - Kununurra
PLO - Port Lincoln
LEA - Exmouth
PQQ - Port Macquarie
PHE - Port Hedland
PER - Perth
PEA - Ironstone
UMR - Woomera
XCH - Christmas Island
RBU - Roebourne
RMA - Roma
NDS - Sandstone
BWU - Sydney
CBR - Canberra
CFS - Coffs Harbour
DBO - Dubbo
SIX - Singleton
SGP - Shay Gap
MJK - Monkey Mia
SBR - Saibai Island
NLK - Burnt Pine
SLJ - Karijini National Park
XRH - Richmond
SYD - Sydney
TMW - Tamworth
WGA - Wagga Wagga
TAQ - Tarcoola
TKY - Turkey Creek
TPR - Tom Price
TYP - Tobermorey
THG - Biloela
TCA - Tennant Creek
TRO - Taree
WLA - Wallal
SYU - Sue Islet
WYA - Whyalla
NTL - Williamtown
WWI - Woodie Woodie
WWY - West Wyalong
BWT - Burnie
YLG - Yalgoo
OKR - Yorke Island
XMY - Yam Island
KYI - Yalata Mission
PEK - Beijing
PKX - Beijing
CIF - Chifeng
CIH - Changzhi
DSN - Ordos
DAT - Datong
ERL - Erenhot
AEB - Baise
HDG - Handan
HET - Hohhot
HLD - Hailar
NAY - Beijing
BAV - Baotou
SHP - Qinhuangdao
SJW - Shijiazhuang
TSN - Tianjin
TGO - Tongliao
HLH - Ulanhot
XIL - Xilinhot
YCU - Yuncheng
TYN - Taiyuan
BHY - Beihai
CGD - Changde
HJJ - Huaihua
DYG - Dayong
FUO - Foshan
CAN - Guangzhou
CSX - Changsha
HNY - Hengyang
HUZ - Huizhou
KWL - Guilin City
LLF - Yongzhou
MXZ - Meixian
NNG - Nanning
SWA - Shantou
ZUH - Zhuhai
SZX - Shenzhen
WUZ - Wuzhou
XIN - Xingning
LZH - Liuzhou
ZHA - Zhanjiang
AYN - Anyang
CGO - Zhengzhou
ENH - Enshi
LHK - Guanghua
WUH - Wuhan
LYA - Luoyang
NNY - Nanyang
SHS - Shashi
XFN - Xiangfan
YIH - Yichang
HAK - Haikou
SYX - Sanya
FNJ - Pyongyang
YJS - Samjiyon
AKA - Ankang
DNH - Dunhuang
GOQ - Golmud
GYU - Guyuan
HZG - Hanzhong
INC - Yinchuan
JIC - Jinchang
JNG - Jining
JGN - Jiayuguan
LHW - Lanzhou
IQN - Qingyang
SIA - Xi'an
THQ - Tianshui
XNN - Xining
XIY - Xianyang
ENY - Yan'an
UYN - Yulin
ZHY - Zhongwei
AVK - Arvaikheer
LTI - Altai
BYN - Bayankhongor
UGA - Bulgan
UGT - Umnugobitour
UBN - Ulaanbaatar
DLZ - Dalanzadgad
HVD - Khovd
MXV - Moron
ULN - Ulan Bator
DLU - Xiaguan
DIG - Shangri-La
LNJ - Lincang
JHG - Jinghong
LJG - Lijiang
LUM - Luxi
KMG - Kunming
SYM - Simao
ZAT - Zhaotong
XMN - Xiamen
AQG - Anqing
BFU - Bengbu
CZX - Changzhou
KHN - Nanchang
DOY - Dongying
FUG - Fuyang
FOC - Fuzhou
JGS - Ji'an
KOW - Ganzhou
HGH - Hangzhou
JDZ - Jingdezhen
JIU - Jiujiang
TNA - Jinan
JUZ - Quzhou
LCX - Longyan
LYG - Lianyungang
HYN - Huangyan
LYI - Linyi
NGB - Ningbo
NKG - Nanjing
NTG - Nantong
HFE - Hefei
PVG - Shanghai
TAO - Qingdao
JJN - Quanzhou
RUG - Rugao
HIA - Huai'an
SQJ - Sanming
SHA - Shanghai
SZV - Suzhou
TXN - Huangshan
WEF - Weifang
WEH - Weihai
WHU - Wuhu
WUX - Wuxi
WUS - Wuyishan
WNZ - Wenzhou
XUZ - Xuzhou
YNZ - Yancheng
YNT - Yantai
YIW - Yiwu
HSN - Zhoushan
NGQ - Shiquanhe
AVA - Anshun
BPX - Bangda
CKG - Chongqing
DAX - Dazhou
GYS - Guangyuan
KWE - Guiyang
JZH - Jiuzhaigou
LIA - Liangping
LXA - Lhasa
LZO - Luzhou
MIG - Mianyang
NAO - Nanchong
LZY - Nyingchi
JIQ - Chongqing
TCZ - Tengchong
TFU - Chengdu
CTU - Chengdu
WXN - Wanxian
XIC - Xichang
YBP - Yibin
ACX - Xingyi
ZYI - Zunyi
AKU - Aksu
AAT - Altay
BPL - Bole
IQM - Qiemo
HMI - Hami
KCA - Kuqa
KRL - Korla
KRY - Karamay
KHG - Kashgar
SXJ - Shanshan
TCG - Tacheng
HTN - Hotan
URC - Urumqi
YIN - Yining
AOG - Anshan
CGQ - Changchun
CNI - Changhai
CHG - Chaoyang
DDG - Dandong
DQA - Daqing Shi
HRB - Harbin
HEK - Heihe
JIL - Jilin
JMU - Jiamusi
JNZ - Jinzhou
LDS - Yichun
YUS - Yushu
MDG - Mudanjiang
OHE - Mohe
NDG - Qiqihar
DLC - Dalian
TNH - Tonghua
SHE - Shenyang
YNJ - Yanji
